二十兆融合宽带 4G融合宽带 宽带类型	宽带
手机套餐与宽带绑定 4G融合宽带 宽带类型	宽带
开套餐免费用宽带 4G融合宽带 宽带类型	宽带
家庭群组宽带 群组宽带 宽带类型	宽带
单品宽带 单品宽带 宽带类型	宽带
融合宽带 4G融合宽带 宽带类型	宽带
4G融合宽带 4G融合宽带 宽带类型	宽带
群组宽带 群组宽带 宽带类型	宽带
群组宽带业务 群组宽带 宽带类型	宽带
办理宽带密码 密码 附属标签	宽带
宽带密码办 密码 附属标签	宽带
怎么办宽带密码 密码 附属标签	宽带
能不能办宽带密码 密码 附属标签	宽带
我的宽带密码怎么办 密码 附属标签	宽带
我家宽带密码怎么办 密码 附属标签	宽带
办一下宽带密码 密码 附属标签	宽带
办理我的宽带密码 密码 附属标签	宽带
办理下我家的宽带密码 密码 附属标签	宽带
办下我的宽带密码 密码 附属标签	宽带
能不能办下我的宽带密码 密码 附属标签	宽带
能不能办下我家的宽带密码 密码 附属标签	宽带
可以帮我办宽带密码么 密码 附属标签	宽带
可以办理宽带密码么 密码 附属标签	宽带
可以办理下我家的宽带的秘密吗 密码 附属标签	宽带
我的的宽带密码帮我办理一下 密码 附属标签	宽带
办理宽带的密码行么 密码 附属标签	宽带
帮我办理宽带的密码 密码 附属标签	宽带
是手机密码 密码 附属标签	手机
宽带的密码 密码 附属标签	宽带
宽带密码服务 密码 附属标签	宽带
移动宽带的密码 密码 附属标签	宽带
手机服务密码 密码 附属标签	手机
宽带密码 密码 附属标签	宽带
宽带登陆密码 密码 附属标签	宽带
宽带上网的密码 密码 附属标签	宽带
我的宽带密码 密码 附属标签	宽带
校园宽带密码 密码 附属标签	宽带
密钥改 密码 附属标签	修改
密钥不记得了 密码 附属标签	重置
密钥忘了 密码 附属标签	重置
密钥重置 密码 附属标签	重置
密钥忘记了 密码 附属标签	重置
改个新密码 密码 附属标签	修改
查一下我的密码 密码 附属标签	查询
我想查下密码 密码 附属标签	查询
帮我查下密码 密码 附属标签	查询
查询密码 密码 附属标签	查询
忘了密码 密码 附属标签	重置
查询密码忘记了怎么办 密码 附属标签	重置
密码忘了怎么整 密码 附属标签	重置
忘记初始密码怎么办 密码 附属标签	重置
原密码忘了 密码 附属标签	重置
查询密码忘记了 密码 附属标签	重置
忘记密码怎么办 密码 附属标签	重置
忘记原密码怎么办 密码 附属标签	重置
密码多少 密码 附属标签	查询
没有重置密码 密码 附属标签	重置
我的密码忘了怎么办 密码 附属标签	重置
客户密码忘记 密码 附属标签	重置
密码忘了怎么办 密码 附属标签	重置
我的密码忘记了 密码 附属标签	重置
查询订单忘记密码怎么办 密码 附属标签	重置
不知道密码 密码 附属标签	重置
改密码 密码 附属标签	修改
修改密码 密码 附属标签	修改
怎么能修改登录密码 密码 附属标签	修改
修改密码跟服务密码是一个吗 密码 附属标签	修改
修改登录密码 密码 附属标签	修改
改密码怎么弄 密码 附属标签	修改
在客户端修改密码 密码 附属标签	修改
如何修改密码 密码 附属标签	修改
怎么样修改密码 密码 附属标签	修改
查询密码错误怎么修改密码 密码 附属标签	修改
在线修改密码 密码 附属标签	修改
不知道服务密码怎么查 密码 附属标签	查询
我的密码给我修改下 密码 附属标签	修改
密码修改下 密码 附属标签	修改
能不能修改下我的密码 密码 附属标签	修改
我的密码修改 密码 附属标签	修改
给我的密码改了 密码 附属标签	修改
修改我的密码 密码 附属标签	修改
我的密码改了 密码 附属标签	修改
修改一下我的密码 密码 附属标签	修改
我要换密码 密码 附属标签	修改
密码改 密码 附属标签	修改
帮我改密码 密码 附属标签	修改
帮我改一下密码 密码 附属标签	修改
帮我修改下密码 密码 附属标签	修改
帮我修改下我得密码 密码 附属标签	修改
帮我修改下我的密码行不行 密码 附属标签	修改
能不能帮我修改下我的密码 密码 附属标签	修改
改了我的密码 密码 附属标签	修改
我忘记密码了 密码 附属标签	重置
重置我得密码 密码 附属标签	重置
帮我重置下密码 密码 附属标签	重置
重置密码 密码 附属标签	重置
密码重置 密码 附属标签	重置
忘记密码重置 密码 附属标签	重置
重置我密码 密码 附属标签	重置
将我的密码重置了 密码 附属标签	重置
忘记密码了重置下 密码 附属标签	重置
密码不记得了重置下 密码 附属标签	重置
能不能帮我重置下密码 密码 附属标签	重置
能不能帮我重置下我的密码 密码 附属标签	重置
可不可以帮我重置下我得密码 密码 附属标签	重置
可不可以帮我重置密码 密码 附属标签	重置
重置下我得密码拜托了 密码 附属标签	重置
帮我重置我的这个什么密码 密码 附属标签	重置
帮我重置下密码记不清了 密码 附属标签	重置
我设置过密码么帮我重置下想不起来了 密码 附属标签	重置
查下我得密码 密码 附属标签	查询
我得密码是什么 密码 附属标签	查询
我得密码是多少 密码 附属标签	查询
密码是啥 密码 附属标签	查询
密码是什么 密码 附属标签	查询
能不能帮我查下我的密码 密码 附属标签	查询
能不能帮我看看我得密码是啥 密码 附属标签	查询
能不能查一下我的密码 密码 附属标签	查询
能不能查一下我的密码是多少 密码 附属标签	查询
帮我查一下我的密码 密码 附属标签	查询
帮我查一下我的密码是多少 密码 附属标签	查询
帮我查询我的密码 密码 附属标签	查询
帮我查询密码 密码 附属标签	查询
密码查询 密码 附属标签	查询
给我的密码查出来 密码 附属标签	查询
能否查出我的密码是多少 密码 附属标签	查询
我密码能查一下么 密码 附属标签	查询
给我查一下密码 密码 附属标签	查询
帮我查一下密码 密码 附属标签	查询
我要查密码 密码 附属标签	查询
密码给我查一下 密码 附属标签	查询
能给我查一下密码吗 密码 附属标签	查询
麻烦帮我查一下密码 密码 附属标签	查询
看看我的密码是多少 密码 附属标签	查询
我密码是多少啊 密码 附属标签	查询
我的密码给我查一下 密码 附属标签	查询
给我查我密码是多少 密码 附属标签	查询
能查密码不 密码 附属标签	查询
你能给我查查密码吗 密码 附属标签	查询
查密码 密码 附属标签	查询
密码是啥呀 密码 附属标签	查询
我密码忘了 密码 附属标签	重置
我密码多少 密码 附属标签	查询
看一下密码 密码 附属标签	查询
密码忘记了 密码 附属标签	重置
我密码是啥呀 密码 附属标签	查询
我密码是啥啊 密码 附属标签	查询
密码忘了咋办 密码 附属标签	重置
我密码是什么 密码 附属标签	查询
我这密码是啥 密码 附属标签	查询
我要查询密码 密码 附属标签	查询
我密码是多少 密码 附属标签	查询
看看密码多少 密码 附属标签	查询
我要咨询密码 密码 附属标签	查询
我的密码是啥 密码 附属标签	查询
给我看看密码 密码 附属标签	查询
初始密码是多少 密码 附属标签	查询
我密码忘了咋办 密码 附属标签	重置
你帮我查查密码 密码 附属标签	查询
我密码是多些 密码 附属标签	查询
我密码怎么查询 密码 附属标签	查询
移动密码是什么 密码 附属标签	查询
我的密码是什么 密码 附属标签	查询
那个密码是啥 密码 附属标签	查询
给我改一个密码 密码 附属标签	修改
我想查一下密码 密码 附属标签	查询
看一下我密码多少 密码 附属标签	查询
我不知道自己密码 密码 附属标签	重置
你告诉我密码是啥 密码 附属标签	查询
给我查下我的密码 密码 附属标签	查询
我不知道密码咋办 密码 附属标签	重置
密码忘记了怎么办 密码 附属标签	重置
帮我看下密码多少 密码 附属标签	查询
给我查查密码多少 密码 附属标签	查询
帮我查询一下密码 密码 附属标签	查询
我密码忘了怎么办 密码 附属标签	重置
你给我查一下密码 密码 附属标签	查询
帮我查下我的密码 密码 附属标签	查询
我想知道我的密码 密码 附属标签	查询
我怎么知道我的密码 密码 附属标签	查询
我想查我密码是多少 密码 附属标签	查询
忘记密码了怎么办 密码 附属标签	重置
我的原始密码是什么 密码 附属标签	查询
我的查询密码是多少 密码 附属标签	查询
我有密码吗是多少 密码 附属标签	查询
能不能看到我的密码 密码 附属标签	查询
给我查查我的密码 密码 附属标签	查询
给我查查我密码是啥 密码 附属标签	查询
我想问一下密码多少 密码 附属标签	查询
我密码忘记了怎么办 密码 附属标签	重置
我的密码没有怎么办 密码 附属标签	重置
我不知道我的密码 密码 附属标签	重置
我想查一下的密码 密码 附属标签	查询
帮我查下密码是多少 密码 附属标签	查询
我想知道我密码是多少 密码 附属标签	查询
请问我的密码是多少 密码 附属标签	查询
给我查询密码是多少 密码 附属标签	查询
我密码忘了怎么设置 密码 附属标签	重置
帮我查一下密码是多少 密码 附属标签	查询
你给我看看我密码是啥 密码 附属标签	查询
我这个密码上哪知道 密码 附属标签	查询
我密码忘了啊怎么办 密码 附属标签	重置
我密码忘了给我查查 密码 附属标签	查询
我的初始密码是多少 密码 附属标签	查询
我想问一下我密码多少 密码 附属标签	查询
给我看一下密码是多少 密码 附属标签	查询
我密码忘了咋整 密码 附属标签	重置
卡密码是啥 密码 附属标签	查询
手机密码多少 密码 附属标签	查询
手机密码是多少 密码 附属标签	查询
手机密码是多些 密码 附属标签	查询
手机密码是啥啊 密码 附属标签	查询
我手机密码多少 密码 附属标签	查询
手机密码是什么 密码 附属标签	查询
这卡密码是啥啊 密码 附属标签	查询
我的卡密码是多少 密码 附属标签	查询
我这卡密码多少啊 密码 附属标签	查询
我手机密码是多少 密码 附属标签	查询
给我查下手机密码 密码 附属标签	查询
帮我看下手机密码 密码 附属标签	查询
手机密码是什么呀 密码 附属标签	查询
看一下我手机密码 密码 附属标签	查询
手机密码是多少啊 密码 附属标签	查询
给我看看手机密码 密码 附属标签	查询
告诉我一个手机密码 密码 附属标签	查询
查一下我的手机密码 密码 附属标签	查询
我的手机密码是什么 密码 附属标签	查询
我这个卡密码是多少 密码 附属标签	查询
我这卡的密码是多少 密码 附属标签	查询
给我发一下我的密码 密码 附属标签	查询
我这张卡密码是多少 密码 附属标签	查询
我想查下本机的密码 密码 附属标签	查询
我这个卡密码是啥啊 密码 附属标签	查询
我的客户密码是多少 密码 附属标签	查询
手机初始密码是什么 密码 附属标签	查询
我手机密码是多少啊 密码 附属标签	查询
我手机的密码是多少 密码 附属标签	查询
我的客服密码是多少 密码 附属标签	查询
我这张卡密码是啥啊 密码 附属标签	查询
我卡的密码是什么啊 密码 附属标签	查询
我要查询我手机密码 密码 附属标签	查询
给我看一下手机密码 密码 附属标签	查询
我手机密码是多少呀 密码 附属标签	查询
你知道我手机密码吗 密码 附属标签	查询
我这张卡密码多少啊 密码 附属标签	查询
我手机卡密码是多少 密码 附属标签	查询
查一下手机的客服密码 密码 附属标签	查询
我这个卡的密码是多少 密码 附属标签	查询
给我查询一下手机密码 密码 附属标签	查询
我的手机密码是什么啊 密码 附属标签	查询
给我看看手机密码多少 密码 附属标签	查询
我的本卡的密码是什么 密码 附属标签	查询
我这手机密码是多少啊 密码 附属标签	查询
看看我手机密码是多少 密码 附属标签	查询
我这张卡的密码是多少 密码 附属标签	查询
我这张卡得密码是多少 密码 附属标签	查询
帮我看下我的手机密码 密码 附属标签	查询
我的卡的密码是多少啊 密码 附属标签	查询
我这个卡的密码是啥啊 密码 附属标签	查询
你给我看一下手机密码 密码 附属标签	查询
你看一下我的手机密码 密码 附属标签	查询
帮我查查手机密码多少 密码 附属标签	查询
查一下手机密码是多少 密码 附属标签	查询
我这张卡密码多少 密码 附属标签	查询
我本卡的密码是多少 密码 附属标签	查询
把密码重置 密码 附属标签	重置
重置下密码 密码 附属标签	重置
初始密码忘了 密码 附属标签	重置
服务密码是啥啊 密码 附属标签	查询
告诉我手机密码 密码 附属标签	查询
我服务密码是啥 密码 附属标签	查询
我手机密码是啥 密码 附属标签	查询
本卡密码是多少 密码 附属标签	查询
本机密码是多少 密码 附属标签	查询
密码要重置一下子 密码 附属标签	重置
密码重置怎么重置 密码 附属标签	重置
我的服务密码是啥 密码 附属标签	查询
我手机密码是什么 密码 附属标签	查询
重置密码怎么设置 密码 附属标签	重置
这张卡密码是多少 密码 附属标签	查询
我卡的密码是多少 密码 附属标签	查询
帮我查一下服务密码 密码 附属标签	查询
你把服务密码告诉我 密码 附属标签	查询
我的服务密码是什么 密码 附属标签	查询
我忘记密码了咋办啊 密码 附属标签	重置
我这服务密码是多少 密码 附属标签	查询
卡的服务密码是什么 密码 附属标签	查询
这个卡的密码是多少 密码 附属标签	查询
我的服务密码是多少 密码 附属标签	查询
我想重置密码怎么设置 密码 附属标签	重置
卡的服务密码是多少啊 密码 附属标签	查询
这张卡服务密码多少啊 密码 附属标签	查询
手机密码忘了给我查查 密码 附属标签	查询
查询一下我的服务密码 密码 附属标签	查询
查查我的服务密码是多少 密码 附属标签	查询
我没有密码啊帮我查一下 密码 附属标签	查询
服务密码多少 密码 附属标签	查询
服务密码是啥 密码 附属标签	查询
服务密码是多少啊 密码 附属标签	查询
服务密码能查到吗 密码 附属标签	查询
服务密码是什么呀 密码 附属标签	查询
手机服务密码是啥 密码 附属标签	查询
手机服务密码是什么 密码 附属标签	查询
我手机服务密码是什么 密码 附属标签	查询
我手机服务密码是多少 密码 附属标签	查询
我这张卡服务密码多少 密码 附属标签	查询
我这卡服务密码是多少 密码 附属标签	查询
我想改密码 密码 附属标签	修改
我改下密码 密码 附属标签	修改
我要改密码 密码 附属标签	修改
改一下密码 密码 附属标签	修改
修改下密码 密码 附属标签	修改
想改个密码 密码 附属标签	修改
我想改个密码 密码 附属标签	修改
我想改下密码 密码 附属标签	修改
密码怎么修改 密码 附属标签	修改
我想修改密码 密码 附属标签	修改
我有密码咋改 密码 附属标签	修改
我想换个密码 密码 附属标签	修改
帮我修改密码 密码 附属标签	修改
我要改下密码 密码 附属标签	修改
我要改个密码 密码 附属标签	修改
给我修改密码 密码 附属标签	修改
帮我改下密码 密码 附属标签	修改
给我换个密码 密码 附属标签	修改
给我改下密码 密码 附属标签	修改
给我改个密码 密码 附属标签	修改
我要修改密码 密码 附属标签	修改
我怎么改密码 密码 附属标签	修改
想改一下密码 密码 附属标签	修改
帮我改个密码 密码 附属标签	修改
我改一下密码 密码 附属标签	修改
密码怎么改 密码 附属标签	修改
密码怎么改啊 密码 附属标签	修改
修改一下密码 密码 附属标签	修改
修改新的密码 密码 附属标签	修改
更改一下密码 密码 附属标签	修改
我想更改密码 密码 附属标签	修改
我要更改密码 密码 附属标签	修改
你给我改个密码 密码 附属标签	修改
我要改一下密码 密码 附属标签	修改
我想改一下密码 密码 附属标签	修改
我想修改下密码 密码 附属标签	修改
给我改一下密码 密码 附属标签	修改
我要改一个密码 密码 附属标签	修改
我要修改下密码 密码 附属标签	修改
我密码怎么修改 密码 附属标签	修改
密码应该怎么改 密码 附属标签	修改
我想修改个密码 密码 附属标签	修改
给我改下密码吧 密码 附属标签	修改
我要换一下密码 密码 附属标签	修改
我想重整个密码 密码 附属标签	重置
您给我改下密码 密码 附属标签	修改
我想要修改密码 密码 附属标签	修改
给我修改下密码 密码 附属标签	修改
我怎么修改密码 密码 附属标签	修改
给我转密码修改 密码 附属标签	修改
帮我修改个密码 密码 附属标签	修改
帮我改下一密码 密码 附属标签	修改
密码可以改吗 密码 附属标签	修改
帮我重新换个密码 密码 附属标签	修改
我想修改一下密码 密码 附属标签	修改
帮我修改一下密码 密码 附属标签	修改
要修改一下密码 密码 附属标签	修改
我想换个密码行嘛 密码 附属标签	修改
怎么办理修改密码 密码 附属标签	修改
我的密码要改一下 密码 附属标签	修改
我想改一下我密码 密码 附属标签	修改
我的密码能不能改 密码 附属标签	修改
我要修改一下密码 密码 附属标签	修改
给我修改一下密码 密码 附属标签	修改
转接密码修改节点 密码 附属标签	修改
我要改个新的密码 密码 附属标签	修改
我服务密码是多少 密码 附属标签	查询
你帮我把密码改下 密码 附属标签	修改
我忘了我的密码了 密码 附属标签	重置
我想修改一次密码 密码 附属标签	修改
转一下密码修改呗 密码 附属标签	修改
咨询修改密码方式 密码 附属标签	修改
我想修改我的密码 密码 附属标签	修改
我想改一个密码 密码 附属标签	修改
给我修改个密码 密码 附属标签	修改
帮我转到修改密码 密码 附属标签	修改
你给我修改个密码 密码 附属标签	修改
我想改一下我的密码 密码 附属标签	修改
我怎么修改我的密码 密码 附属标签	修改
我改一下我这张密码 密码 附属标签	修改
我想修改简单的密码 密码 附属标签	修改
我想把密码修改一下 密码 附属标签	修改
我怎么能修改密码 密码 附属标签	修改
我想把密码改一下 密码 附属标签	修改
我这密码能改一个么 密码 附属标签	修改
你好我想改下密码 密码 附属标签	修改
我想改下密码咋办 密码 附属标签	修改
你帮我把密码修改下 密码 附属标签	修改
我想改密码怎么改 密码 附属标签	修改
给我转一下密码修改 密码 附属标签	修改
我想改下密码怎么办 密码 附属标签	修改
我有原密码我要修改 密码 附属标签	修改
我想重置密码怎么办 密码 附属标签	重置
你帮我改个密码呗 密码 附属标签	修改
给我从新改一个密码 密码 附属标签	修改
没有密码帮我改下 密码 附属标签	修改
我想修改密码怎么办 密码 附属标签	修改
我想修改一下我的密码 密码 附属标签	修改
改一个我能记住的密码 密码 附属标签	修改
密码不好记我能换吗 密码 附属标签	修改
密码记不住重改一个 密码 附属标签	修改
我想改一个自己的密码 密码 附属标签	修改
我有原密码如何修改 密码 附属标签	修改
忘了密码帮我转一下 密码 附属标签	重置
帮我看看我这密码是啥 密码 附属标签	查询
我要修改密码咋改啊 密码 附属标签	修改
我想要重新修改密码 密码 附属标签	修改
帮我重新修改一下密码 密码 附属标签	修改
给我改下我的密码 密码 附属标签	修改
我想改个能记住的密码 密码 附属标签	修改
我怎么改一下我的密码 密码 附属标签	修改
修改密码或者从设密码 密码 附属标签	修改
我有密码要重改一下 密码 附属标签	修改
帮我查一下宽带密码 密码 附属标签	查询
帮我看看密码是多少 密码 附属标签	查询
如何查询宽带密码 密码 附属标签	查询
之前设置的密码是多少 密码 附属标签	查询
我的宽带密码怎么查询 密码 附属标签	查询
给我查一下我的运营商密码多少 密码 附属标签	查询
我的客户服务密码是多少 密码 附属标签	查询
我查询话费的密码是多少 密码 附属标签	查询
查一下我手机的服务密码 密码 附属标签	查询
密码是多少 密码 附属标签	查询
运营商密码是什么 密码 附属标签	查询
我想设一个新的密码 密码 附属标签	重置
我不知道原来的密码是什么 密码 附属标签	查询
密码修改 密码 附属标签	修改
忘记密码了 密码 附属标签	重置
我的密码想改一下 密码 附属标签	修改
我的密码找不到了 密码 附属标签	重置
我的密码忘了你帮我查一下 密码 附属标签	查询
查一下密码 密码 附属标签	查询
改个密码 密码 附属标签	修改
设个密码 密码 附属标签	重置
查一下手机密码 密码 附属标签	查询
怎么修改密码 密码 附属标签	修改
我想重置个密码 密码 附属标签	重置
我想重置密码 密码 附属标签	重置
查查宽带密码 密码 附属标签	查询
你帮我查一下我的密码 密码 附属标签	查询
可以修改密码吗 密码 附属标签	修改
重新设置密码 密码 附属标签	重置
我的宽带密码是多少 密码 附属标签	查询
我的手机密码是多少 密码 附属标签	查询
我想更换一下我的密码 密码 附属标签	修改
我想把密码换一下 密码 附属标签	修改
重新设置一下密码 密码 附属标签	重置
怎样修改密码 密码 附属标签	修改
我的密码是多少 密码 附属标签	查询
宽带密码是什么 密码 附属标签	查询
告诉我我的密码 密码 附属标签	查询
重设密码 密码 附属标签	重置
重设下密码 密码 附属标签	重置
重设个密码 密码 附属标签	重置
我密码忘了能告诉我吗 密码 附属标签	查询
我需要重新设置一个新密码 密码 附属标签	重置
我的密码忘了想重新获取一下 密码 附属标签	重置
重新设置个密码 密码 附属标签	重置
流量加油套餐 加油包 流量业务对象类型	流量
上网加油套餐 加油包 流量业务对象类型	流量
流量加油包 加油包 流量业务对象类型	流量
有加油包 加油包 流量业务对象类型	流量
国内流量加油包 加油包 流量业务对象类型	流量
数据流量加油包 加油包 流量业务对象类型	流量
流量加油包全国的 加油包 流量业务对象类型	流量
流量加油包详情 加油包 流量业务对象类型	流量
加油套餐包 加油包 流量业务对象类型	流量
实惠的国内流量加油包 加油包 流量业务对象类型	流量
国内加油流量包 加油包 流量业务对象类型	流量
加油流量 加油包 流量业务对象类型	流量
4g飞享套餐加油包 加油包 流量业务对象类型	流量
4g加油包 加油包 流量业务对象类型	流量
一次性加油包 加油包 流量业务对象类型	流量
国内通用流量加油包 加油包 流量业务对象类型	流量
一次性加油包是多长时间的 加油包 流量业务对象类型	流量
流量加油包发送什么 加油包 流量业务对象类型	流量
推荐个实惠的流量加油包要国内的 加油包 流量业务对象类型	流量
加油包是国内流量吗 加油包 流量业务对象类型	流量
一天流量包 日流量包 流量业务对象类型	流量
一天包 日流量包 流量业务对象类型	流量
小时流量可以共享吗 小时流量包 流量业务对象类型	流量
能否先使用小时流量包 小时流量包 流量业务对象类型	流量
流量小时包内含多少流量 小时流量包 流量业务对象类型	流量
小时流量包 小时流量包 流量业务对象类型	流量
夜间流量是什么时间 夜间流量包 流量业务对象类型	流量
夜间包能包月吗 夜间流量包 流量业务对象类型	流量
夜间流量包怎么用 夜间流量包 流量业务对象类型	流量
流量包夜间 夜间流量包 流量业务对象类型	流量
夜间流量是什么时间段 夜间流量包 流量业务对象类型	流量
全国流量闲时流量叠加包 夜间流量包 流量业务对象类型	流量
夜间流量起止时间 夜间流量包 流量业务对象类型	流量
周末包是多少的 周末流量包 流量业务对象类型	流量
周末包使用规则 周末流量包 流量业务对象类型	流量
周末包是国内流量吗 周末流量包 流量业务对象类型	流量
周末包是国内的吗 周末流量包 流量业务对象类型	流量
这个周末包是全国流量么 周末流量包 流量业务对象类型	流量
周末包是多少 周末流量包 流量业务对象类型	流量
周末流量包时间 周末流量包 流量业务对象类型	流量
周末包什么时候失效 周末流量包 流量业务对象类型	流量
周末包是省内还是全国流量 周末流量包 流量业务对象类型	流量
周末流量包是什么 周末流量包 流量业务对象类型	流量
周末短时包是省内还是全国流量 周末流量包 流量业务对象类型	流量
办个七十元的基础 70 金额	开通
全国用的三十元流量 30 金额	流量
三十元一g国内流量 30 金额	流量
三十元一g流量包 30 金额	流量
三十元国内包 30 金额	流量
三十元国内一g流量 30 金额	流量
三十元的一g流量 30 金额	流量
三十元一g包 30 金额	流量
三十元一g的国内流量 30 金额	流量
三十元一g流量 30 金额	流量
一百元国内包 100 金额	流量
一百元一个月十五g流量 100 金额	流量
三百元三十g包 300 金额	流量
三百元三十g的国内流量 300 金额	流量
二元二g天包是一天两元还是这4天总共两元 2 金额	流量
五元五百兆流量包 5 金额	流量
五元五百兆 5 金额	流量
五元五百兆的是从话费里扣 5 金额	流量
五元五百兆发什么信息 5 金额	流量
五元包五百兆是立即生效吗 5 金额	流量
五元五百兆流量 5 金额	流量
五元五百兆怎么扣钱 5 金额	流量
五元五百兆使用期限 5 金额	流量
五元五百兆流量是不是两天 5 金额	流量
五元五百兆两天的 5 金额	流量
我五元五百兆 5 金额	流量
五元包两天五百如何开始使用 5 金额	流量
五元五百兆特惠流量怎么用 5 金额	流量
4g三十元流量包 30 金额	流量
三十元多少流量 30 金额	流量
三十元一g是每月吗 30 金额	流量
那个三十元一g一个月的流量 30 金额	流量
三十元数据流量 30 金额	流量
三十元的数据流量套餐 30 金额	流量
你好国内流量三十元是多少 30 金额	流量
三十元一个g 30 金额	流量
三十元是多少兆流量 30 金额	流量
我想三十元一g的 30 金额	流量
五十元二g 50 金额	流量
五十元二g套餐 50 金额	流量
五十元二g全国流量 50 金额	流量
五十元二个g的国内流量 50 金额	流量
五十元二g国内流量 50 金额	流量
五十元二g流量套餐 50 金额	流量
五十元二g流量 50 金额	流量
五十元二g是怎么回事 50 金额	流量
五十元二g套餐什么意思 50 金额	流量
4g套餐五十元二g国内流量 50 金额	流量
4g套餐五十元国内流量 50 金额	流量
五十元是二个g的国内流量吗 50 金额	流量
五十元每月二g 50 金额	流量
五十元多少g 50 金额	流量
五十元二个g 50 金额	流量
五十元二g我可以选吗 50 金额	流量
五十元二g流量包 50 金额	流量
五十元二g代码是什么 50 金额	流量
4g流量全国版五十元档 50 金额	流量
五十元每月二g流量 50 金额	流量
五十元每月二g流量包 50 金额	流量
七十元三g 70 金额	流量
七十元包括三g流量吗 70 金额	流量
七十元国内三g 70 金额	流量
七十元月流量包 70 金额	流量
一百元的流量套餐详细 100 金额	流量
一百元五g 100 金额	流量
一百元包括五g流量吗 100 金额	流量
一百元五g的 100 金额	流量
4g套餐一百元五g 100 金额	流量
一百五十元十g国内流量 150 金额	流量
一百五十元十g 150 金额	流量
有一百五十元十g的吗 150 金额	流量
一百元一个月十g流量 100 金额	流量
一百五十元十g流量套餐 150 金额	流量
二百元十五g国内流量 200 金额	流量
二百元十五g 200 金额	流量
有二百元十五g的吗 200 金额	流量
二百元十五g流量套餐 200 金额	流量
三百元三十g国内流量 300 金额	流量
4g飞享套餐国内版三百元国内流量可选包 300 金额	流量
三百元流量套餐 300 金额	流量
三百元流量 300 金额	流量
三百元三十g 300 金额	流量
三百元国内三十g数据流量包 300 金额	流量
三百元月流量包 300 金额	流量
三百元三十g流量包 300 金额	流量
4g三百元流量包 300 金额	流量
三百元国内流量包 300 金额	流量
三百元全国流量 300 金额	流量
三百元多少流量 300 金额	流量
三百元流量包 300 金额	流量
三百元三十g是每月吗 300 金额	流量
4g套餐三百元三十g 300 金额	流量
三百元左右套餐都有哪种 300 金额	套餐
那个三百元三十g一个月的流量 300 金额	流量
三百元的国内流量 300 金额	流量
三百元国内三十g流量 300 金额	流量
三百元能包多少流量 300 金额	流量
三百元数据流量 300 金额	流量
三百元三十g流量 300 金额	流量
三百元的三十g流量 300 金额	流量
三百元的数据流量套餐 300 金额	流量
你好国内流量三百元是多少 300 金额	流量
三百元三十个g 300 金额	流量
三百元是多少的流量 300 金额	流量
二十元三百兆国内流量套餐详情 20 金额	流量
这个流量是不是只有4小时有用 4 数字	流量
六元五百兆 6 金额	流量
十元一g的流量包是几天的包 10 金额	流量
十元一g全国流量是全天可用的吗 10 金额	流量
三百元是什么套餐 300 金额	套餐
办个七十的基础 70 数字	开通
怎么开十元一天的 10 金额	开通
开通十元一天的 10 金额	开通
怎么开通十元一天用的 10 金额	开通
怎么开通十元包一天的 10 金额	开通
你好我想办一个十元一天的 10 金额	开通
六元包五百在哪个页面里 6 金额	开通
六元办理4个小时 6 金额	开通
家庭成员绑定的宽带 群组宽带 宽带类型	宽带
手机密码服务 密码 附属标签	手机
这张卡的密码 密码 附属标签	手机
卡的服务密码 密码 附属标签	手机
这个号服务密码 密码 附属标签	手机
本机的服务密码 密码 附属标签	手机
我想要个手机密码 密码 附属标签	手机
怎么设置手机密码 密码 附属标签	手机
我的卡密码怎么设置 密码 附属标签	手机
我手机密码怎么获取 密码 附属标签	手机
帮我设置下手机密码 密码 附属标签	手机
这卡服务密码 密码 附属标签	手机
这个卡的服务密码 密码 附属标签	手机
怎么设置客服密码啊 密码 附属标签	手机
服务密码怎么设置 密码 附属标签	手机
怎么设置服务密码 密码 附属标签	手机
服务密码给我整过来 密码 附属标签	手机
我要办理服务密码 密码 附属标签	手机
我的手机密码 密码 附属标签	手机
宽带服务密码 密码 附属标签	宽带
我的服务密码 密码 附属标签	手机
手机密码 密码 附属标签	手机
给我设置个手机密码 密码 附属标签	手机
移动卡密码 密码 附属标签	手机
移动卡的密码 密码 附属标签	手机
设置宽带密码 密码 附属标签	宽带
密码忘了有什么办法吗 密码 附属标签	重置
手机密码找不到了怎么办 密码 附属标签	重置手机
我这张手机卡的密码 密码 附属标签	手机
服务密码 密码 附属标签	手机
基础流量 基础流量包 流量业务对象类型	流量
基础流量包 基础流量包 流量业务对象类型	流量
基础流量业务 基础流量包 流量业务对象类型	流量
基础流量套餐 基础流量包 流量业务对象类型	流量
上网加油包 加油包 流量业务对象类型	流量
加油包 加油包 流量业务对象类型	流量
国内加油包 加油包 流量业务对象类型	流量
国内流量包加油包 加油包 流量业务对象类型	流量
加油包流量 加油包 流量业务对象类型	流量
临时加油包 加油包 流量业务对象类型	流量
国内流量加油 加油包 流量业务对象类型	流量
流量日套餐 日流量包 流量业务对象类型	流量
小时流量包业务 小时流量包 流量业务对象类型	流量
流量小时包 小时流量包 流量业务对象类型	流量
小时包 小时流量包 流量业务对象类型	流量
夜间流量 夜间流量包 流量业务对象类型	流量
夜间流量包 夜间流量包 流量业务对象类型	流量
夜流量 夜间流量包 流量业务对象类型	流量
夜流量包 夜间流量包 流量业务对象类型	流量
夜间流量套餐 夜间流量包 流量业务对象类型	流量
国内夜间流量 夜间流量包 流量业务对象类型	流量
国内夜间流量包 夜间流量包 流量业务对象类型	流量
夜间流量包资费 夜间流量包 流量业务对象类型	流量
夜间闲时流量 夜间流量包 流量业务对象类型	流量
国内闲时包 夜间流量包 流量业务对象类型	流量
周末流量 周末流量包 流量业务对象类型	流量
周末流量包 周末流量包 流量业务对象类型	流量
周末包 周末流量包 流量业务对象类型	流量
流量周末包 周末流量包 流量业务对象类型	流量
流量周末短时包 周末流量包 流量业务对象类型	流量
三十元流量套餐 30 金额	流量
三十元流量 30 金额	流量
三十元国内流量包 30 金额	流量
三十元流量包 30 金额	流量
三十元的国内流量 30 金额	流量
五十元流量套餐 50 金额	流量
七十元流量套餐 70 金额	流量
七十元国内流量套餐 70 金额	流量
三十元全国流量 30 金额	流量
4g套餐三十元一g 30 金额	流量
五十元流量包 50 金额	流量
国内五十元流量套餐 50 金额	流量
五十元两g的国内流量包 50 金额	流量
五十元的流量包 50 金额	流量
七十元流量包 70 金额	流量
七十元国内流量 70 金额	流量
一百元流量包 100 金额	流量
一百元的流量套餐 100 金额	流量
一百元的流量套餐资费 100 金额	流量
一百元国内流量包 100 金额	流量
一百元全国流量 100 金额	流量
一百五十元流量包 150 金额	流量
二百元左右的流量套餐 200 金额	流量
二百元国内流量 200 金额	流量
二百元流量套餐 200 金额	流量
二百元的流量包 200 金额	流量
二百元流量包 200 金额	流量
二十元流量包 20 金额	流量
二十元的流量包 20 金额	流量
十兆独享宽带多少钱 单品宽带 宽带类型	咨询宽带
二十兆独享宽带多少钱 单品宽带 宽带类型	咨询宽带
一百兆独享宽带多少钱 单品宽带 宽带类型	咨询宽带
五十兆独享宽带多少钱 单品宽带 宽带类型	咨询宽带
一百五十兆独享宽带多少钱 单品宽带 宽带类型	咨询宽带
二百兆独享宽带多少钱 单品宽带 宽带类型	咨询宽带
敢不敢把单品宽带给我介绍一下 单品宽带 宽带类型	咨询宽带
我想知道4g融合宽带是什么 4G融合宽带 宽带类型	咨询宽带
4g融合宽带的价格 4G融合宽带 宽带类型	咨询宽带
帮我介绍下4g融合宽带的资费 4G融合宽带 宽带类型	咨询宽带
4g融合宽带有多少种 4G融合宽带 宽带类型	咨询宽带
4g融合宽带是怎么收费的 4G融合宽带 宽带类型	咨询宽带
4g融合宽带是什么你给我讲一下 4G融合宽带 宽带类型	咨询宽带
4g融合宽带可以给我介绍下吗 4G融合宽带 宽带类型	咨询宽带
能不能给我介绍下4g融合宽带 4G融合宽带 宽带类型	咨询宽带
4g融合宽带是什么宽带 4G融合宽带 宽带类型	咨询宽带
4g融合宽带是个什么东西 4G融合宽带 宽带类型	咨询宽带
4g融合宽带快么 4G融合宽带 宽带类型	咨询宽带
4g融合宽带多少钱 4G融合宽带 宽带类型	咨询宽带
4g融合宽带怎么收钱的 4G融合宽带 宽带类型	咨询宽带
什么是4g融合宽带 4G融合宽带 宽带类型	咨询宽带
介绍下4g融合宽带 4G融合宽带 宽带类型	咨询宽带
介绍下你们移动的4g融合宽带 4G融合宽带 宽带类型	咨询宽带
你们移动的4g融合宽带是个什么玩意 4G融合宽带 宽带类型	咨询宽带
4g融合宽带给我介绍下 4G融合宽带 宽带类型	咨询宽带
敢不敢把4g融合宽带给我介绍一下 4G融合宽带 宽带类型	咨询宽带
帮我介绍下4g融合宽带 4G融合宽带 宽带类型	咨询宽带
敢不敢把群组宽带给我介绍一下 群组宽带 宽带类型	咨询宽带
有飞享套餐绑定的宽带吗 4G融合宽带 宽带类型	咨询宽带
有一家人一起用的免费宽带吗 群组宽带 宽带类型	咨询宽带
有家庭组合办宽带业务吗 群组宽带 宽带类型	咨询宽带
单独安装宽带多少钱 单品宽带 宽带类型	预约宽带
只装宽带有什么样的 单品宽带 宽带类型	预约宽带
二人消费一百能用宽带吗 群组宽带 宽带类型	咨询宽带
二十兆单品宽带如何办理 单品宽带 宽带类型	预约宽带
我想办理4g融合宽带 4G融合宽带 宽带类型	预约宽带
多人群组宽带如何办理 群组宽带 宽带类型	预约宽带
融合宽带介绍 4G融合宽带 宽带类型	咨询宽带
群组宽带资费介绍 群组宽带 宽带类型	咨询宽带
单品宽带是多少钱的 单品宽带 宽带类型	咨询宽带
家庭宽带资费 群组宽带 宽带类型	咨询宽带
单品宽带介绍 单品宽带 宽带类型	咨询宽带
给我介绍一下单品宽带 单品宽带 宽带类型	咨询宽带
我想了解一下单品宽带 单品宽带 宽带类型	咨询宽带
单品宽带怎么收费 单品宽带 宽带类型	咨询宽带
4g融合宽带怎么收费 4G融合宽带 宽带类型	咨询宽带
给我介绍一下融合宽带 4G融合宽带 宽带类型	咨询宽带
我想了解一下4g融合宽带 4G融合宽带 宽带类型	咨询宽带
4g融合宽带介绍 4G融合宽带 宽带类型	咨询宽带
4g融合宽带是什么 4G融合宽带 宽带类型	咨询宽带
群组宽带资费 群组宽带 宽带类型	咨询宽带
什么是群组宽带 群组宽带 宽带类型	咨询宽带
有单品宽带资费吗 单品宽带 宽带类型	咨询宽带
单品宽带的资费介绍 单品宽带 宽带类型	咨询宽带
单品宽带资费是什么 单品宽带 宽带类型	咨询宽带
4G融合宽带资费 4G融合宽带 宽带类型	咨询宽带
4G融合宽带资费是什么 4G融合宽带 宽带类型	咨询宽带
我想了解4G融合宽带 4G融合宽带 宽带类型	咨询宽带
移动融合宽带的资费 4G融合宽带 宽带类型	咨询宽带
融合宽带的资费是什么样的 4G融合宽带 宽带类型	咨询宽带
群组消费宽带资费介绍 群组宽带 宽带类型	咨询宽带
群组宽带的资费介绍 群组宽带 宽带类型	咨询宽带
我想了解一下群组宽带 群组宽带 宽带类型	咨询宽带
说一下群组宽带资费 群组宽带 宽带类型	咨询宽带
你们的群组宽带资费是什么呀 群组宽带 宽带类型	咨询宽带
单品宽带多少钱 单品宽带 宽带类型	咨询宽带
单品宽带资费介绍 单品宽带 宽带类型	咨询宽带
群组宽带如何收费 群组宽带 宽带类型	咨询宽带
群组宽带怎么收费 群组宽带 宽带类型	咨询宽带
给我说一下融合宽带 4G融合宽带 宽带类型	咨询宽带
给我说一下单品宽带 单品宽带 宽带类型	咨询宽带
群组宽带多少钱 群组宽带 宽带类型	咨询宽带
融合宽带多少钱 4G融合宽带 宽带类型	咨询宽带
融合宽带怎么收费 4G融合宽带 宽带类型	咨询宽带
融合宽带怎么收费的 4G融合宽带 宽带类型	咨询宽带
介绍群组宽带 群组宽带 宽带类型	咨询宽带
融合宽带是多少钱的 4G融合宽带 宽带类型	咨询宽带
什么是单品宽带 单品宽带 宽带类型	咨询宽带
融合宽带资费 4G融合宽带 宽带类型	咨询宽带
融合宽带资费介绍 4G融合宽带 宽带类型	咨询宽带
单品宽带资费 单品宽带 宽带类型	咨询宽带
群组宽带是多少钱的 群组宽带 宽带类型	咨询宽带
介绍一下群组宽带 群组宽带 宽带类型	咨询宽带
群组宽带多少钱的 群组宽带 宽带类型	咨询宽带
群组宽带介绍 群组宽带 宽带类型	咨询宽带
介绍一下融合宽带 4G融合宽带 宽带类型	咨询宽带
介绍一下单品宽带 单品宽带 宽带类型	咨询宽带
融合宽带是什么样的 4G融合宽带 宽带类型	咨询宽带
单独包宽带多少钱 单品宽带 宽带类型	咨询宽带
本机手机秘钥忘记 密码 附属标签	重置手机
我银行卡还有一点钱全都充了话费吧 银行卡 附属标签	办理手机充值
我想用银行卡充一点话费 银行卡 附属标签	办理手机充值
给我充电话费用银行卡那种方式 银行卡 附属标签	办理手机充值
我要用建行的卡充话费 银行卡 附属标签	办理手机充值
我想用农行给话费多充点 银行卡 附属标签	办理手机充值
银行卡充一点话费 银行卡 附属标签	办理手机充值
我想给手机交的话费用输银行卡号那种方式 银行卡 附属标签	办理手机充值
帮我交一点话费吧用银行卡好吗 银行卡 附属标签	办理手机充值
我要用银行卡给我的手机交一点话费 银行卡 附属标签	办理手机充值
我想用银行卡给我的手机交一点话费好吗 银行卡 附属标签	办理手机充值
银行卡还能冲话费吗赶紧给我充吧 银行卡 附属标签	办理手机充值
我要用银行卡充一些话费 银行卡 附属标签	办理手机充值
可以用信用卡给手机充话费吗 银行卡 附属标签	办理手机充值
银行卡也可以用一零零八六充话费吗我要试试 银行卡 附属标签	办理手机充值
我充值卡还有一点钱全都充了话费吧 充值卡 附属标签	办理手机充值
我想用充值卡充一点话费 充值卡 附属标签	办理手机充值
充值卡充一点话费 充值卡 附属标签	办理手机充值
帮我交一点话费吧用充值卡好吗 充值卡 附属标签	办理手机充值
我要用充值卡给我的手机交一点话费 充值卡 附属标签	办理手机充值
我想用充值卡给我的手机交一点话费好吗 充值卡 附属标签	办理手机充值
我要用充值卡充一些话费 充值卡 附属标签	办理手机充值
充值卡也可以用一零零八六充话费吗我要试试 充值卡 附属标签	办理手机充值
重置下我得宽带密码拜托了 密码 附属标签	重置宽带
帮我重置下宽带密码记不清了 密码 附属标签	重置宽带
我设置过宽带密码么帮我重置下想不起来了 密码 附属标签	重置宽带
怎么重新设置宽带密码 密码 附属标签	重置宽带
重新设置宽带密码 密码 附属标签	重置宽带
把修改宽带密码的方法发过来 密码 附属标签	修改宽带
我有充值卡怎么充值呀 充值卡 附属标签	办理手机充值
用银行卡为本机交话费 银行卡 附属标签	办理手机充值
我手机的服务密码忘了我该怎么办 密码 附属标签	重置手机
我想重新设置一下我的手机密码 密码 附属标签	重置手机
重新设置一下手机服务密码 密码 附属标签	重置手机
我想让你帮我修改一下我的手机的服务密码 密码 附属标签	修改手机
我想让你把我的手机的服务密码修改一下 密码 附属标签	修改手机
重置手机服务密码 密码 附属标签	重置手机
我以前没设置过宽带密码 密码 附属标签	重置宽带
智能语音能修改宽带密码吗 密码 附属标签	修改宽带
我可以用银行卡交话费吗 银行卡 附属标签	办理手机充值
你这里能用银行卡充话费吗 银行卡 附属标签	办理手机充值
用银行卡交费 银行卡 附属标签	办理手机充值
充值卡交费 充值卡 附属标签	办理手机充值
重置宽带密码 密码 附属标签	重置宽带
能修改宽带密码吗 密码 附属标签	修改宽带
帮我更换一下宽带密码 密码 附属标签	修改宽带
重新设置个手机密码 密码 附属标签	重置手机
改一下手机密码 密码 附属标签	修改手机
怎么修改宽带密码 密码 附属标签	修改宽带
怎么用银行卡交费 银行卡 附属标签	办理手机充值
我用充值卡怎么交钱啊 充值卡 附属标签	办理手机充值
我的手机密码忘了应该怎么办 密码 附属标签	重置手机
我用银行卡怎么给手机交话费 银行卡 附属标签	办理手机充值
把我宽带密码改一下 密码 附属标签	修改宽带
我用银联卡怎么充值啊 银行卡 附属标签	办理手机充值
我有银行卡怎么充话费 银行卡 附属标签	办理手机充值
我想用银联卡给手机充话费 银行卡 附属标签	办理手机充值
给我重置个上网密码 密码 附属标签	重置宽带
使用身份证重设宽带密码 密码 附属标签	重置宽带
怎么重设手机密码 密码 附属标签	重置手机
重设下服务密码 密码 附属标签	重置手机
重设个宽带密码 密码 附属标签	重置宽带
给我重设个服务密码 密码 附属标签	重置手机
重新设置个上网密码 密码 附属标签	重置宽带
你帮我重新设一个手机密码 密码 附属标签	重置手机
开通基础流量包功能 基础流量包 流量业务对象类型	开通流量
基础流量包功能开通 基础流量包 流量业务对象类型	开通流量
帮我开通基础流量包 基础流量包 流量业务对象类型	开通流量
你好请帮我开通基础流量包 基础流量包 流量业务对象类型	开通流量
我想开通基础流量包 基础流量包 流量业务对象类型	开通流量
我想开基础流量包功能 基础流量包 流量业务对象类型	开通流量
我想开通基础流量包功能 基础流量包 流量业务对象类型	开通流量
开通国内基础流量 基础流量包 流量业务对象类型	开通流量
开通基础流量包方式 基础流量包 流量业务对象类型	开通流量
开通流量基础包 基础流量包 流量业务对象类型	开通流量
我要开通省外基础流量 基础流量包 流量业务对象类型	开通流量
开通基础流量怎么开 基础流量包 流量业务对象类型	开通流量
开通月基础流量包 基础流量包 流量业务对象类型	开通流量
国内基础流量开通方法 基础流量包 流量业务对象类型	开通流量
普通基础流量怎么开通 基础流量包 流量业务对象类型	开通流量
如何开通流量基础包 基础流量包 流量业务对象类型	开通流量
想开通基础流量 基础流量包 流量业务对象类型	开通流量
基础流量怎么开通 基础流量包 流量业务对象类型	开通流量
我开通基础流量包 基础流量包 流量业务对象类型	开通流量
开通4g流量基础包 基础流量包 流量业务对象类型	开通流量
4g流量基础包介绍 基础流量包 流量业务对象类型	开通流量
开通4g流量基础套餐 基础流量包 流量业务对象类型	开通流量
怎么开通国内基础流量包 基础流量包 流量业务对象类型	开通流量
如何开通国内基础流量包 基础流量包 流量业务对象类型	开通流量
开通个国内基础流量 基础流量包 流量业务对象类型	开通流量
你好帮我开通国内基础流量包 基础流量包 流量业务对象类型	开通流量
怎样开通国内基础流量包 基础流量包 流量业务对象类型	开通流量
我这个套餐怎么加基础流量 基础流量包 流量业务对象类型	开通流量
怎样开通基础流量包 基础流量包 流量业务对象类型	开通流量
开通基础流量的方式 基础流量包 流量业务对象类型	开通流量
开通流量基础包月 基础流量包 流量业务对象类型	开通流量
我要开通省外基础流量包 基础流量包 流量业务对象类型	开通流量
如何开通4g基础流量 基础流量包 流量业务对象类型	开通流量
怎样开通4g基础流量包 基础流量包 流量业务对象类型	开通流量
办理4g基础流量套餐 基础流量包 流量业务对象类型	开通流量
办理4g基础流量包 基础流量包 流量业务对象类型	开通流量
4g基础流量包办理 基础流量包 流量业务对象类型	开通流量
如何办理4g基础流量套餐业务 基础流量包 流量业务对象类型	开通流量
基础流量套餐开通 基础流量包 流量业务对象类型	开通流量
如何开通十五g的基础流量费用多少 基础流量包 流量业务对象类型	开通流量
如何开通十g的基础流量费用多少 基础流量包 流量业务对象类型	开通流量
取消基础流量包 基础流量包 流量业务对象类型	取消流量
基础流量包取消了 基础流量包 流量业务对象类型	取消流量
把我基础流量包取消 基础流量包 流量业务对象类型	取消流量
请取消我的基础流量包 基础流量包 流量业务对象类型	取消流量
请将我的基础流量包取消 基础流量包 流量业务对象类型	取消流量
我要取消基础流量包 基础流量包 流量业务对象类型	取消流量
我要将我的基础流量包取消掉 基础流量包 流量业务对象类型	取消流量
你能不能取消掉我的基础流量包 基础流量包 流量业务对象类型	取消流量
你可不可以取消我的基础流量包 基础流量包 流量业务对象类型	取消流量
请你帮我取消基础流量包 基础流量包 流量业务对象类型	取消流量
请帮我将基础流量包取消 基础流量包 流量业务对象类型	取消流量
我不要基础流量包了 基础流量包 流量业务对象类型	取消流量
我需要你帮我取消基础流量包 基础流量包 流量业务对象类型	取消流量
我需要将基础流量包取消 基础流量包 流量业务对象类型	取消流量
将我办理的基础流量包取消 基础流量包 流量业务对象类型	取消流量
请把我办理的基础流量包取消 基础流量包 流量业务对象类型	取消流量
我不需要基础流量包了 基础流量包 流量业务对象类型	取消流量
不需要基础流量包了 基础流量包 流量业务对象类型	取消流量
把基础流量包取消 基础流量包 流量业务对象类型	取消流量
把我的基础流量包给取消了 基础流量包 流量业务对象类型	取消流量
我要取消基础流量 基础流量包 流量业务对象类型	取消流量
给我取消基础流量包 基础流量包 流量业务对象类型	取消流量
帮我取消下基础流量包 基础流量包 流量业务对象类型	取消流量
能给我基础流量包取消了吗 基础流量包 流量业务对象类型	取消流量
我想取消基础流量包 基础流量包 流量业务对象类型	取消流量
我订的基础流量包麻烦帮我取消了 基础流量包 流量业务对象类型	取消流量
基础流量包取消 基础流量包 流量业务对象类型	取消流量
流量基础包取消 基础流量包 流量业务对象类型	取消流量
我订的基础流量包取消了吧 基础流量包 流量业务对象类型	取消流量
我的基础流量包不想要了 基础流量包 流量业务对象类型	取消流量
关闭流量基础套餐 基础流量包 流量业务对象类型	取消流量
开通基础流量包 基础流量包 流量业务对象类型	开通流量
开通流量加油 加油包 流量业务对象类型	开通流量
你好我想开通流量加油 加油包 流量业务对象类型	开通流量
帮我开通流量加油 加油包 流量业务对象类型	开通流量
请帮我开通流量加油 加油包 流量业务对象类型	开通流量
你好请帮我开通流量加油 加油包 流量业务对象类型	开通流量
我想开通流量加油 加油包 流量业务对象类型	开通流量
我要办国内加油包 加油包 流量业务对象类型	开通流量
怎么买流量加油包 加油包 流量业务对象类型	开通流量
我想买个加油包 加油包 流量业务对象类型	开通流量
给我开加油包 加油包 流量业务对象类型	开通流量
怎么开通加油包 加油包 流量业务对象类型	开通流量
办理流量加油包 加油包 流量业务对象类型	开通流量
开通加油包 加油包 流量业务对象类型	开通流量
想办个全国加油包 加油包 流量业务对象类型	开通流量
没流量了办个加油包 加油包 流量业务对象类型	开通流量
给我开通流量加油包 加油包 流量业务对象类型	开通流量
开通一次性加油包 加油包 流量业务对象类型	开通流量
如何办理流量加油包 加油包 流量业务对象类型	开通流量
办理流量加油包一个月的 加油包 流量业务对象类型	开通流量
你好我想办理加油包 加油包 流量业务对象类型	开通流量
你好我想开一个流量加油包 加油包 流量业务对象类型	开通流量
开通流量加油包国内 加油包 流量业务对象类型	开通流量
我需要国内流量加油包应该办理哪个套餐 加油包 流量业务对象类型	开通流量
怎么开通省外流量加油包 加油包 流量业务对象类型	开通流量
我打算办个流量加油包 加油包 流量业务对象类型	开通流量
我想办理国内的流量加油包 加油包 流量业务对象类型	开通流量
加油包办理 加油包 流量业务对象类型	开通流量
如何开通加油包 加油包 流量业务对象类型	开通流量
开通一次性流量加油包 加油包 流量业务对象类型	开通流量
想办理个加油包 加油包 流量业务对象类型	开通流量
流量加油包怎么开通 加油包 流量业务对象类型	开通流量
我要办理流量加油包 加油包 流量业务对象类型	开通流量
我想办理加油包 加油包 流量业务对象类型	开通流量
加油包咋办理 加油包 流量业务对象类型	开通流量
我可以办啥加油包 加油包 流量业务对象类型	开通流量
手机短信如何开通流量一次性加油包啊 加油包 流量业务对象类型	开通流量
怎样办理流量加油包 加油包 流量业务对象类型	开通流量
你好我想办理一个月的流量加油包你有什么推荐的 加油包 流量业务对象类型	开通流量
能帮家人包加油包吗 加油包 流量业务对象类型	开通流量
你好流量加油包都有多少的 加油包 流量业务对象类型	开通流量
怎么使用加油包 加油包 流量业务对象类型	开通流量
怎么没有流量加油包啊 加油包 流量业务对象类型	开通流量
有即时生效一个月的加油流量包吗 加油包 流量业务对象类型	开通流量
国内加油包有哪些 加油包 流量业务对象类型	开通流量
你好我想办理一下国内流量加油包 加油包 流量业务对象类型	开通流量
一个月的国内流量加油包有吗 加油包 流量业务对象类型	开通流量
我能办理什么加油包 加油包 流量业务对象类型	开通流量
怎么充值加油包主要是充流量 加油包 流量业务对象类型	开通流量
有流量加油包吗 加油包 流量业务对象类型	开通流量
国内加油包有哪几种选择 加油包 流量业务对象类型	开通流量
我现在能办理什么样的流量加油包 加油包 流量业务对象类型	开通流量
国内加油包有便宜的吗 加油包 流量业务对象类型	开通流量
有什么便宜的流量加油包吗 加油包 流量业务对象类型	开通流量
外出国内套餐有加油包吗 加油包 流量业务对象类型	开通流量
国内通用的加油包有什么样的啊 加油包 流量业务对象类型	开通流量
有没有国内流量加油包 加油包 流量业务对象类型	开通流量
想知道都有哪些加油包 加油包 流量业务对象类型	开通流量
国内流量加油包有哪些 加油包 流量业务对象类型	开通流量
加油包有吗 加油包 流量业务对象类型	开通流量
有国内流量加油包么 加油包 流量业务对象类型	开通流量
加油包有多少钱的 加油包 流量业务对象类型	开通流量
我想加油流量出省在国内使用怎么办合适 加油包 流量业务对象类型	开通流量
有国内流量加油包吗 加油包 流量业务对象类型	开通流量
国内流量加油包有吗 加油包 流量业务对象类型	开通流量
没有流量了有没有合适的加油包 加油包 流量业务对象类型	开通流量
加油包有什么 加油包 流量业务对象类型	开通流量
有全国流量加油包吗 加油包 流量业务对象类型	开通流量
短信如何开通一次性加油包 加油包 流量业务对象类型	开通流量
怎么办理手机加油包 加油包 流量业务对象类型	开通流量
开通一百兆的加油包 加油包 流量业务对象类型	开通流量
我要办理一百兆流量加油包 加油包 流量业务对象类型	开通流量
给我办一个五百兆的流量加油包 加油包 流量业务对象类型	开通流量
我不想要加油包了 加油包 流量业务对象类型	取消流量
流量加油包关闭 加油包 流量业务对象类型	取消流量
取消所有流量加油包 加油包 流量业务对象类型	取消流量
有加油包吗 加油包 流量业务对象类型	开通流量
日流量包开通 日流量包 流量业务对象类型	开通流量
包天流量包 日流量包 流量业务对象类型	开通流量
办理一天流量包 日流量包 流量业务对象类型	开通流量
全国用的一天流量包如何开通 日流量包 流量业务对象类型	开通流量
能不能只包一天一g的流量 日流量包 流量业务对象类型	开通流量
我想买一天一g的流量 日流量包 流量业务对象类型	开通流量
我只开一天一g的 日流量包 流量业务对象类型	开通流量
开通日套餐 日流量包 流量业务对象类型	开通流量
给我办理一个一g一天的 日流量包 流量业务对象类型	开通流量
怎么开通十一g包一天的 日流量包 流量业务对象类型	开通流量
你好我想办一个一g一天的 日流量包 流量业务对象类型	开通流量
你给我开通一个一g日套餐 日流量包 流量业务对象类型	开通流量
我去省外一天怎么开通流量 日流量包 流量业务对象类型	开通流量
我想开通全国包天流量包 日流量包 流量业务对象类型	开通流量
全国用的单天流量怎么开通 日流量包 流量业务对象类型	开通流量
我想开通全国单天流量包 日流量包 流量业务对象类型	开通流量
我想办理二十4小时一g流量套餐 日流量包 流量业务对象类型	开通流量
有国内一天包吗 日流量包 流量业务对象类型	开通流量
有一天包吗国内的 日流量包 流量业务对象类型	开通流量
能不能只包一天的流量 日流量包 流量业务对象类型	开通流量
我想取消日流量包 日流量包 流量业务对象类型	取消流量
帮我把日流量包取消了吧 日流量包 流量业务对象类型	取消流量
刚才开了一个日流量包后悔了取消了吧 日流量包 流量业务对象类型	取消流量
取消二十4小时的流量包 日流量包 流量业务对象类型	取消流量
取消日流量包 日流量包 流量业务对象类型	取消流量
日流量包取消了 日流量包 流量业务对象类型	取消流量
把我日流量包取消 日流量包 流量业务对象类型	取消流量
请取消我的日流量包 日流量包 流量业务对象类型	取消流量
请将我的日流量包取消 日流量包 流量业务对象类型	取消流量
我要取消日流量包 日流量包 流量业务对象类型	取消流量
我要将我的日流量包取消掉 日流量包 流量业务对象类型	取消流量
你能不能取消掉我的日流量包 日流量包 流量业务对象类型	取消流量
你可不可以取消我的日流量包 日流量包 流量业务对象类型	取消流量
请你帮我取消日流量包 日流量包 流量业务对象类型	取消流量
请帮我将日流量包取消 日流量包 流量业务对象类型	取消流量
我不要日流量包了 日流量包 流量业务对象类型	取消流量
我需要你帮我取消日流量包 日流量包 流量业务对象类型	取消流量
我需要将日流量包取消 日流量包 流量业务对象类型	取消流量
将我办理的日流量包取消 日流量包 流量业务对象类型	取消流量
请把我办理的日流量包取消 日流量包 流量业务对象类型	取消流量
我不需要日流量包了 日流量包 流量业务对象类型	取消流量
不需要日流量包了 日流量包 流量业务对象类型	取消流量
把日流量包取消 日流量包 流量业务对象类型	取消流量
把我的日流量包给取消了 日流量包 流量业务对象类型	取消流量
我要取消包天的流量 日流量包 流量业务对象类型	取消流量
退订二十4小时流量包 日流量包 流量业务对象类型	取消流量
取消包天流量包 日流量包 流量业务对象类型	取消流量
取消二十4小时流量包 日流量包 流量业务对象类型	取消流量
取消一天的流量包 日流量包 流量业务对象类型	取消流量
我要取消二十4小时流量包 日流量包 流量业务对象类型	取消流量
有一天流量包吗 日流量包 流量业务对象类型	开通流量
日流量套餐有哪些 日流量包 流量业务对象类型	开通流量
开通日流量 日流量包 流量业务对象类型	开通流量
开通一个日间流量包 日流量包 流量业务对象类型	开通流量
有没有白天能用的流量包都有哪些流量包 日流量包 流量业务对象类型	开通流量
日流量套餐是下月自动取消还是需要自己取消 日流量包 流量业务对象类型	取消流量
办理小时流量包 小时流量包 流量业务对象类型	开通流量
进入小时流量包办理 小时流量包 流量业务对象类型	开通流量
查一下小时流量包办理 小时流量包 流量业务对象类型	开通流量
查一下办理小时流量包 小时流量包 流量业务对象类型	开通流量
查一下我能办理的小时流量包 小时流量包 流量业务对象类型	开通流量
办理小时流量 小时流量包 流量业务对象类型	开通流量
办理国内流量小时包 小时流量包 流量业务对象类型	开通流量
办理流量小时包 小时流量包 流量业务对象类型	开通流量
小时包介绍 小时流量包 流量业务对象类型	开通流量
有小时包吗 小时流量包 流量业务对象类型	开通流量
有小时包么 小时流量包 流量业务对象类型	开通流量
取消小时流量包 小时流量包 流量业务对象类型	取消流量
小时流量包取消了 小时流量包 流量业务对象类型	取消流量
把我小时流量包取消 小时流量包 流量业务对象类型	取消流量
请取消我的小时流量包 小时流量包 流量业务对象类型	取消流量
请将我的小时流量包取消 小时流量包 流量业务对象类型	取消流量
我要取消小时流量包 小时流量包 流量业务对象类型	取消流量
我要将我的小时流量包取消掉 小时流量包 流量业务对象类型	取消流量
你能不能取消掉我的小时流量包 小时流量包 流量业务对象类型	取消流量
你可不可以取消我的小时流量包 小时流量包 流量业务对象类型	取消流量
请你帮我取消小时流量包 小时流量包 流量业务对象类型	取消流量
请帮我将小时流量包取消 小时流量包 流量业务对象类型	取消流量
我不要小时流量包了 小时流量包 流量业务对象类型	取消流量
我需要你帮我取消小时流量包 小时流量包 流量业务对象类型	取消流量
我需要将小时流量包取消 小时流量包 流量业务对象类型	取消流量
将我办理的小时流量包取消 小时流量包 流量业务对象类型	取消流量
请把我办理的小时流量包取消 小时流量包 流量业务对象类型	取消流量
我不需要小时流量包了 小时流量包 流量业务对象类型	取消流量
不需要小时流量包了 小时流量包 流量业务对象类型	取消流量
把小时流量包取消 小时流量包 流量业务对象类型	取消流量
把我的小时流量包给取消了 小时流量包 流量业务对象类型	取消流量
取消流量小时包 小时流量包 流量业务对象类型	取消流量
小时流量包有哪些 小时流量包 流量业务对象类型	开通流量
小时流量包怎么开通 小时流量包 流量业务对象类型	开通流量
开通小时流量包 小时流量包 流量业务对象类型	开通流量
开通夜间上网包 夜间流量包 流量业务对象类型	开通流量
夜间流量套餐都有什么 夜间流量包 流量业务对象类型	开通流量
包流量夜间的 夜间流量包 流量业务对象类型	开通流量
夜间国内流量包怎么订购 夜间流量包 流量业务对象类型	开通流量
夜间流量开启 夜间流量包 流量业务对象类型	开通流量
上月包的夜间流量包这个月怎么还有呢不是到月底自动取消吗 夜间流量包 流量业务对象类型	取消流量
我想订购一g夜间通用流量 夜间流量包 流量业务对象类型	开通流量
如何用短信订夜间流量包 夜间流量包 流量业务对象类型	开通流量
有没有夜间流量 夜间流量包 流量业务对象类型	开通流量
夜间流量编辑什么开通 夜间流量包 流量业务对象类型	开通流量
你好请问夜间流量是什么样的可以介绍下吗 夜间流量包 流量业务对象类型	开通流量
怎么开通夜间流量叠加包 夜间流量包 流量业务对象类型	开通流量
闲时流量是怎那么办理 夜间流量包 流量业务对象类型	开通流量
请问夜间流量月底是自动取消还是 夜间流量包 流量业务对象类型	取消流量
取消闲时流星怎么操作 夜间流量包 流量业务对象类型	取消流量
现在可以把我的夜间流量取消吗 夜间流量包 流量业务对象类型	取消流量
怎样用短信取消夜间流量包 夜间流量包 流量业务对象类型	取消流量
怎么取消夜间专用流量 夜间流量包 流量业务对象类型	取消流量
我要把夜间流量取消可以么 夜间流量包 流量业务对象类型	取消流量
可随时取消夜间流量包吗 夜间流量包 流量业务对象类型	取消流量
我想要取消夜间流量套餐 夜间流量包 流量业务对象类型	取消流量
怎么样取消夜间流量包 夜间流量包 流量业务对象类型	取消流量
我要取消夜间流量包 夜间流量包 流量业务对象类型	取消流量
怎么取消那个夜间流量 夜间流量包 流量业务对象类型	取消流量
我想把我所办理的夜间流量套餐给取消办理 夜间流量包 流量业务对象类型	取消流量
你好你能把夜间流量包给我取消了吗 夜间流量包 流量业务对象类型	取消流量
取消夜间一g的流量 夜间流量包 流量业务对象类型	取消流量
可以帮我把那个夜间流量套餐取消了吗 夜间流量包 流量业务对象类型	取消流量
我想取消夜间流量套餐需发送什么取消 夜间流量包 流量业务对象类型	取消流量
夜间流量包怎样取消 夜间流量包 流量业务对象类型	取消流量
我想要把夜间流量包取消 夜间流量包 流量业务对象类型	取消流量
如何取消夜间闲时流量叠加包 夜间流量包 流量业务对象类型	取消流量
刚才定的夜间流量怎么取消 夜间流量包 流量业务对象类型	取消流量
我想取消我那个夜间流量 夜间流量包 流量业务对象类型	取消流量
取消夜间业务怎么办理 夜间流量包 流量业务对象类型	取消流量
取消夜间流量短信发什么 夜间流量包 流量业务对象类型	取消流量
能帮我把夜间流量的业务取消吗 夜间流量包 流量业务对象类型	取消流量
你好想把夜间流量取消 夜间流量包 流量业务对象类型	取消流量
流量闲时包能取消吗 夜间流量包 流量业务对象类型	取消流量
请问如何取消夜间流量套餐 夜间流量包 流量业务对象类型	取消流量
可不可以取消夜间流量套餐 夜间流量包 流量业务对象类型	取消流量
取消夜间流量包亲 夜间流量包 流量业务对象类型	取消流量
已开通的夜间流量可以取消吗 夜间流量包 流量业务对象类型	取消流量
取消夜间业务 夜间流量包 流量业务对象类型	取消流量
取消夜间一g流量 夜间流量包 流量业务对象类型	取消流量
怎样取消夜间一g流量包 夜间流量包 流量业务对象类型	取消流量
帮忙取消夜间流量吧 夜间流量包 流量业务对象类型	取消流量
把我开的夜间流量取消吧 夜间流量包 流量业务对象类型	取消流量
我要取消夜间全国流量包 夜间流量包 流量业务对象类型	取消流量
你能帮我取消了这个夜间流量包吗 夜间流量包 流量业务对象类型	取消流量
我办理了夜间流量套餐能帮我取消吗 夜间流量包 流量业务对象类型	取消流量
如何取消包的夜间流量 夜间流量包 流量业务对象类型	取消流量
已开通的夜间流量包怎样取消 夜间流量包 流量业务对象类型	取消流量
怎样取消国内包一次夜间流量包 夜间流量包 流量业务对象类型	取消流量
你好帮我取消夜间流量包谢谢 夜间流量包 流量业务对象类型	取消流量
怎样取消国内包一g夜间流量包 夜间流量包 流量业务对象类型	取消流量
你好我想问一下夜间流量包怎么取消 夜间流量包 流量业务对象类型	取消流量
全国闲时流量取消 夜间流量包 流量业务对象类型	取消流量
取消闲时流量包 夜间流量包 流量业务对象类型	取消流量
闲时流量包取消 夜间流量包 流量业务对象类型	取消流量
我想取消闲时流量包 夜间流量包 流量业务对象类型	取消流量
取消闲时包 夜间流量包 流量业务对象类型	取消流量
闲时流量包怎么取消 夜间流量包 流量业务对象类型	取消流量
如何取消闲时叠加流量包 夜间流量包 流量业务对象类型	取消流量
如何取消闲时流量包 夜间流量包 流量业务对象类型	取消流量
怎样取消闲时流量叠加包 夜间流量包 流量业务对象类型	取消流量
闲时流量能取消嘛 夜间流量包 流量业务对象类型	取消流量
闲时流量叠加包怎么取消 夜间流量包 流量业务对象类型	取消流量
如何取消国内夜间闲时流量叠加包 夜间流量包 流量业务对象类型	取消流量
取消闲时流量叠加包 夜间流量包 流量业务对象类型	取消流量
能把那个闲时优惠包取消了吗 夜间流量包 流量业务对象类型	取消流量
取消闲时优惠包 夜间流量包 流量业务对象类型	取消流量
取消闲时流量叠加 夜间流量包 流量业务对象类型	取消流量
闲时流量包使用多长时间后可以取消 夜间流量包 流量业务对象类型	取消流量
取消流量闲时流量叠加包 夜间流量包 流量业务对象类型	取消流量
取消全国流量闲时流量叠加包 夜间流量包 流量业务对象类型	取消流量
怎样取消闲时国内流量 夜间流量包 流量业务对象类型	取消流量
我要取消闲时流量叠加包 夜间流量包 流量业务对象类型	取消流量
我要取消一g全国流量闲时流量叠加包 夜间流量包 流量业务对象类型	取消流量
怎么取消全国流量闲时流量叠加包 夜间流量包 流量业务对象类型	取消流量
怎么把我夜间上网套餐取消 夜间流量包 流量业务对象类型	取消流量
取消国内一g夜间流量 夜间流量包 流量业务对象类型	取消流量
取消安心流量包和夜间流量套餐 夜间流量包 流量业务对象类型	取消流量
给我取消夜间包 夜间流量包 流量业务对象类型	取消流量
夜间流量套餐可以取消吗 夜间流量包 流量业务对象类型	取消流量
我想取消夜间流量包怎么在线操作 夜间流量包 流量业务对象类型	取消流量
请帮我取消夜间流量包 夜间流量包 流量业务对象类型	取消流量
夜间流量套餐能取消吗 夜间流量包 流量业务对象类型	取消流量
想取消夜间流量包怎么弄 夜间流量包 流量业务对象类型	取消流量
取消专用夜间流量 夜间流量包 流量业务对象类型	取消流量
怎样取消夜间流量套餐 夜间流量包 流量业务对象类型	取消流量
可以取消我的夜间流量包吗 夜间流量包 流量业务对象类型	取消流量
给我取消夜间流量套餐 夜间流量包 流量业务对象类型	取消流量
夜间流量咋取消 夜间流量包 流量业务对象类型	取消流量
取消夜间包一g流量怎么做 夜间流量包 流量业务对象类型	取消流量
帮我取消夜间流量包 夜间流量包 流量业务对象类型	取消流量
夜间流量包取消业务 夜间流量包 流量业务对象类型	取消流量
请问怎么取消夜间流量包 夜间流量包 流量业务对象类型	取消流量
我可以取消夜间流量包吗 夜间流量包 流量业务对象类型	取消流量
把晚上用的流量取消 夜间流量包 流量业务对象类型	取消流量
我要取消晚间流量包 夜间流量包 流量业务对象类型	取消流量
夜间流量我不用了 夜间流量包 流量业务对象类型	取消流量
取消闲时流量 夜间流量包 流量业务对象类型	取消流量
帮我取消夜间流量 夜间流量包 流量业务对象类型	取消流量
关闭夜间流量 夜间流量包 流量业务对象类型	取消流量
取消夜间流量 夜间流量包 流量业务对象类型	取消流量
我要取消夜间流量 夜间流量包 流量业务对象类型	取消流量
我要取消夜间用流量包 夜间流量包 流量业务对象类型	取消流量
有晚上上网的流量吗 夜间流量包 流量业务对象类型	开通流量
开通晚上用的流量 夜间流量包 流量业务对象类型	开通流量
夜间的流量包有什么样的 夜间流量包 流量业务对象类型	开通流量
有哪些夜间流量套餐 夜间流量包 流量业务对象类型	开通流量
我想开一个晚上用的流量包 夜间流量包 流量业务对象类型	开通流量
我想开一个周末用的流量包 周末流量包 流量业务对象类型	开通流量
开通周末流量包 周末流量包 流量业务对象类型	开通流量
周末流量办理 周末流量包 流量业务对象类型	开通流量
刚才包二天包五元五百兆为什么没有到账 周末流量包 流量业务对象类型	开通流量
流量两天包五元五百兆是全国可用吗 周末流量包 流量业务对象类型	开通流量
周末流量包是开通就可以用吗 周末流量包 流量业务对象类型	开通流量
为什么我办理不了周末包 周末流量包 流量业务对象类型	开通流量
我想问一下要是包个周末流量包怎么给中国移动发短信 周末流量包 流量业务对象类型	开通流量
我刚刚包了周末包现在怎么用 周末流量包 流量业务对象类型	开通流量
周末包是怎么开通 周末流量包 流量业务对象类型	开通流量
我刚刚办理的周末包现在能用了吗 周末流量包 流量业务对象类型	开通流量
有国内流量周末包么 周末流量包 流量业务对象类型	开通流量
有国内周末包吗 周末流量包 流量业务对象类型	开通流量
我怎么办理周末包 周末流量包 流量业务对象类型	开通流量
我想问一下要是包个周末流量包怎么办理 周末流量包 流量业务对象类型	开通流量
我想办周末短时包 周末流量包 流量业务对象类型	开通流量
周末短时包如何开通 周末流量包 流量业务对象类型	开通流量
周末流量包包是多少钱的 周末流量包 流量业务对象类型	开通流量
周末短时流量包开通一下 周末流量包 流量业务对象类型	开通流量
开通周末短时包 周末流量包 流量业务对象类型	开通流量
我可以先使用那个五元五百流量的那个吗 周末流量包 流量业务对象类型	开通流量
取消周末流量包 周末流量包 流量业务对象类型	取消流量
周末流量包取消了 周末流量包 流量业务对象类型	取消流量
把我周末流量包取消 周末流量包 流量业务对象类型	取消流量
请取消我的周末流量包 周末流量包 流量业务对象类型	取消流量
请将我的周末流量包取消 周末流量包 流量业务对象类型	取消流量
我要取消周末流量包 周末流量包 流量业务对象类型	取消流量
我要将我的周末流量包取消掉 周末流量包 流量业务对象类型	取消流量
你能不能取消掉我的周末流量包 周末流量包 流量业务对象类型	取消流量
你可不可以取消我的周末流量包 周末流量包 流量业务对象类型	取消流量
请你帮我取消周末流量包 周末流量包 流量业务对象类型	取消流量
请帮我将周末流量包取消 周末流量包 流量业务对象类型	取消流量
我不要周末流量包了 周末流量包 流量业务对象类型	取消流量
我需要你帮我取消周末流量包 周末流量包 流量业务对象类型	取消流量
我需要将周末流量包取消 周末流量包 流量业务对象类型	取消流量
将我办理的周末流量包取消 周末流量包 流量业务对象类型	取消流量
请把我办理的周末流量包取消 周末流量包 流量业务对象类型	取消流量
我不需要周末流量包了 周末流量包 流量业务对象类型	取消流量
不需要周末流量包了 周末流量包 流量业务对象类型	取消流量
把周末流量包取消 周末流量包 流量业务对象类型	取消流量
把我的周末流量包给取消了 周末流量包 流量业务对象类型	取消流量
我要关闭周末流量包 周末流量包 流量业务对象类型	取消流量
帮我办理下周末流量包 周末流量包 流量业务对象类型	开通流量
我想开一个周六用的流量包 周末流量包 流量业务对象类型	开通流量
办理周末流量包 周末流量包 流量业务对象类型	开通流量
开通周末流量加油包 周末流量包 流量业务对象类型	开通流量
嗯你好我要办理三十元基础套餐 30 金额	办理套餐
嗯你好我要办理五十元基础套餐 50 金额	办理套餐
嗯你好我要办理七十元基础套餐 70 金额	办理套餐
嗯你好我要办理一百元基础套餐 100 金额	办理套餐
嗯你好我要办理一百五元基础套餐 150 金额	办理套餐
嗯你好我要办理二百元基础套餐 200 金额	办理套餐
嗯你好我要办理三百元基础套餐 300 金额	办理套餐
你们有三十元的流量包吗 30 金额	开通流量
帮我开个一百五十的流量 150 金额	开通流量
你们有没有三十的流量包 30 金额	开通流量
可以开一百的全国流量吗 100 金额	开通流量
帮我办个一百五十的流量包 150 金额	开通流量
给办理个二百的流量包吧 200 金额	开通流量
有没有三百元流量 300 金额	开通流量
我想办理个七十的流量包 70 金额	开通流量
我手机需要开通三百的流量包 300 金额	开通流量
我想要七十元包三个g的流量 70 金额	开通流量
三百元的流量包能开吗 300 金额	开通流量
给我开个五十的流量包 50 金额	开通流量
有没有三百元的流量给我开一个 300 金额	开通流量
我能开三百元的流量吗 300 金额	开通流量
怎么办理六元五百兆流量包 6 金额	开通流量
我要国内十元一g流量 10 金额	开通流量
我包了二十的流量包怎么改成三十的 30 金额	开通流量
开通4十元七百兆流量包 40 金额	开通流量
开十元流量包 10 金额	开通流量
办理二十元流量 20 金额	开通流量
开通十元4g流量包 10 金额	开通流量
开通二天流量包 2 数字	开通流量
开通十元流量 10 金额	开通流量
三十元包一g流量 30 金额	开通流量
三十元包一g有吗 30 金额	开通流量
三十元国内流量给我开通 30 金额	开通流量
充五十元二g流量包 50 金额	开通流量
七十元包三g国内流量包怎么办 70 金额	开通流量
你好我定个七十元三g的流量 70 金额	开通流量
怎么办一百五十元包十g流量 150 金额	开通流量
我想开通一百五十元的流量包 150 金额	开通流量
一百元十五g流量包如何办理 100 金额	开通流量
三百元包多少流量 300 金额	开通流量
三百元包流量一个月 300 金额	开通流量
三百元包三十g的流量 300 金额	开通流量
三百元包三十g的全国流量 300 金额	开通流量
没有办理二十元三百兆业务 20 金额	开通流量
开通二十元三百兆套餐 20 金额	开通流量
帮我开通流量包九元一g 9 金额	开通流量
发短信怎么开通十元一g流量 10 金额	开通流量
十元一g流量短信怎么开通 10 金额	开通流量
十元一g包开通短信 10 金额	开通流量
十元一g流量怎么发短信订 10 金额	开通流量
十元一g的国内流量包短信怎样开通 10 金额	开通流量
开通一百元4g流量包 100 金额	开通流量
你好我定个五十元二g的流量 50 金额	开通流量
我要开通一百元的全国流量业务 100 金额	开通流量
我能办个三百元的流量包吗 300 金额	开通流量
开个十块钱的流量 10 金额	开通流量
二十元流量包多少 20 金额	开通流量
怎么发短信包十元一g 10 金额	开通流量
开通十元一g流量包发送什么短信 10 金额	开通流量
怎么开通十元一g短期包呢 10 金额	开通流量
短信开通十元一g发短信怎么开 10 金额	开通流量
有五元五百兆的没 5 金额	开通流量
我在网上办理的五元五百兆在哪里扣费 5 金额	开通流量
有五元五百兆的没月 5 金额	开通流量
开通五元五百兆 5 金额	开通流量
办理了五元包五百兆流量包怎么不生效 5 金额	开通流量
包五元五百兆发信息发什么 5 金额	开通流量
我定一个五元五百兆的流量包 5 金额	开通流量
有没有五元五百兆的 5 金额	开通流量
我定一个五元五百流量包 5 金额	开通流量
五元包五百兆 5 金额	开通流量
短信回复啥办理五元五百兆 5 金额	开通流量
开通五元五百兆流量包 5 金额	开通流量
开通五元五百兆流量需要发送数字多少 5 金额	开通流量
两天包五元五百兆流量从何处扣费 5 金额	开通流量
开通五元包五百兆流量这个业务 5 金额	开通流量
我想办理五元五百兆怎么办不了啊 5 金额	开通流量
办理五元两天五百兆的流量包 5 金额	开通流量
我刚办理了五元五百兆 5 金额	开通流量
刚刚办理了五元五百兆 5 金额	开通流量
我想问下刚刚办理了五元五百兆的国内流量从哪儿扣款的 5 金额	开通流量
怎么办理二天用的流量包 2 数字	开通流量
我开通了五元五百兆的怎么查了一下没到账啊 5 金额	开通流量
我刚才包的五元五百兆为什么没显示啊 5 金额	开通流量
每月三十元包多少流量 30 金额	开通流量
是三十元包一g的吗 30 金额	开通流量
三十元包一g流量包 30 金额	开通流量
三十元国内流量包一g 30 金额	开通流量
我可以办理三十元一g流量吗 30 金额	开通流量
三十元能包多少流量 30 金额	开通流量
三十元流量套餐包有哪些 30 金额	开通流量
三十元包一个g 30 金额	开通流量
三十元包国内一个g 30 金额	开通流量
国内流量三十元一g怎么办 30 金额	开通流量
三十元包一g国内流量包 30 金额	开通流量
三十元包一g 30 金额	开通流量
帮我办一个三十元一g的国内流量 30 金额	开通流量
三十元包一g的流量 30 金额	开通流量
4g飞享套餐国内版五十元国内流量可选包介绍 50 金额	开通流量
五十元包二g流量怎么办 50 金额	开通流量
五十元包二g国内流量电话咋收费 50 金额	开通流量
五十元4g流量包介绍 50 金额	开通流量
我的流量包能换成五十元这个嘛 50 金额	开通流量
五十元二g国内现在可以开通吗 50 金额	开通流量
开通五十元国内流量包 50 金额	开通流量
五十元包二g国内多长时间 50 金额	开通流量
开通五十元二g流量包 50 金额	开通流量
五十元包国内二g流量 50 金额	开通流量
五十元可以买多少流量 50 金额	开通流量
五十元二g流量的怎么包的 50 金额	开通流量
我现在包的是五十元一g流量可以改成二g吗 50 金额	开通流量
五十元包二g 50 金额	开通流量
五十元包国内二g数据流量 50 金额	开通流量
五十元包二g国内流量 50 金额	开通流量
五十元二g流量是怎么订购的 50 金额	开通流量
五十元二g国内流量怎么办的 50 金额	开通流量
办理五十元二g 50 金额	开通流量
五十元二g国内流量是怎么订购的 50 金额	开通流量
五十元包二g全国流量 50 金额	开通流量
我可以包五十元二g的流量吗 50 金额	开通流量
五十元包二g国内流量套餐 50 金额	开通流量
五十元包国内二g 50 金额	开通流量
开通五十元二g流量服务 50 金额	开通流量
你好五十元二g国内流量怎么开通 50 金额	开通流量
开个五十元每月二g流量 50 金额	开通流量
你能直接开五十元包二g全国流量吗 50 金额	开通流量
我能开通五十元二个g的国内流量吗 50 金额	开通流量
七十元国内流量套餐开通 70 金额	开通流量
开通七十元流量包 70 金额	开通流量
开通七十元流量 70 金额	开通流量
开通七十元三个g的流量 70 金额	开通流量
七十元三g流量开通 70 金额	开通流量
开通七十元包全国流量 70 金额	开通流量
办理七十元三g流量包 70 金额	开通流量
七十元三g流量开通方式 70 金额	开通流量
我想开通七十元国内数据流量怎么开通呢 70 金额	开通流量
我的是七十元二g能不能改七十元三g的 70 金额	开通流量
开通七十元包国内三g套餐 70 金额	开通流量
七十元包三g流量包怎么开 70 金额	开通流量
开通七十元包国内三g 70 金额	开通流量
你们介绍的七十元三g怎么开通 70 金额	开通流量
把七十元的流量包开通 70 金额	开通流量
请问有这个流量包吗每月七十元三g国内流量 70 金额	开通流量
怎么开通七十元包三g的业务 70 金额	开通流量
开通七十元包三g流量包 70 金额	开通流量
给我开通七十元的流量套餐 70 金额	开通流量
我想开通七十元三g的国内流量包应该咋办 70 金额	开通流量
您好帮我开通一下七十元包三g的套餐吧 70 金额	开通流量
七十元包三g开通 70 金额	开通流量
七十元流量包是怎么开通的 70 金额	开通流量
七十元包国内三g 70 金额	开通流量
开通七十元包国内三g数据流量 70 金额	开通流量
帮我开通七十元三g的业务 70 金额	开通流量
七十元包国内三g数据流量 70 金额	开通流量
开通七十元三g流量包 70 金额	开通流量
帮我开通七十元流量包 70 金额	开通流量
我能不能开通国内七十元流量包 70 金额	开通流量
能不能开通国内七十元流量 70 金额	开通流量
开通七十元包三g 70 金额	开通流量
我想包七十元三g的流量包 70 金额	开通流量
开通七十元包三g国内流量 70 金额	开通流量
如何开通七十元包三g流量 70 金额	开通流量
开通七十元二g国内流量套餐 70 金额	开通流量
开通七十元三g 70 金额	开通流量
开通七十元流量套餐 70 金额	开通流量
怎么开通七十元三g流量包 70 金额	开通流量
如何开通七十元三g的国内流量套餐 70 金额	开通流量
开通七十元三g流量 70 金额	开通流量
我想开通七十元国内流量怎么开通呢 70 金额	开通流量
我可以办理七十元三g流量包吗 70 金额	开通流量
七十元三g流量包是怎么开通的 70 金额	开通流量
七十元包国内三g流量开通 70 金额	开通流量
我能不能开通国内七十元三g流量包 70 金额	开通流量
七十元流量怎么开通 70 金额	开通流量
开通七十元三个g的国内流量 70 金额	开通流量
七十元三g国内流量开通 70 金额	开通流量
办理七十元三g的全国流量包 70 金额	开通流量
你能直接开七十元全国流量吗 70 金额	开通流量
我能开通七十元三个g的国内流量吗 70 金额	开通流量
七十元包三g流量 70 金额	开通流量
你好我想办七十元三g的有吗 70 金额	开通流量
你好我定个七十元全国流量 70 金额	开通流量
老用户七十元包三g流量怎么开 70 金额	开通流量
一百元包五g 100 金额	开通流量
4g飞享套餐国内版一百元国内流量可选包介绍 100 金额	开通流量
4g套餐一百元流量办理方式 100 金额	开通流量
开通一百元国内流量套餐包 100 金额	开通流量
开通一百元五g流量包 100 金额	开通流量
4g套餐一百元包五g数据流量怎样开通 100 金额	开通流量
一百元包五g流量可以开通吗 100 金额	开通流量
帮我开通一百元国内流量包 100 金额	开通流量
开通一百元国内流量 100 金额	开通流量
开通一百元流量业务 100 金额	开通流量
你好请帮我把一百元国内流量包开通了 100 金额	开通流量
我包一百元五g 100 金额	开通流量
开通一百元包流量 100 金额	开通流量
一百元五g流量包怎么开通 100 金额	开通流量
我要开一百元国内流量 100 金额	开通流量
一百元五g国内流量包开通 100 金额	开通流量
怎样开通一百元五g流量包 100 金额	开通流量
怎样开通一百元国内流量包 100 金额	开通流量
如何开通国内流量一百元套餐 100 金额	开通流量
开通一百元包五g 100 金额	开通流量
一百元五g国内流量怎么办理 100 金额	开通流量
4g飞享套餐国内版一百元国内流量介绍 100 金额	开通流量
开通一百元国内流量套餐 100 金额	开通流量
帮我开通一下一百元五g流量包 100 金额	开通流量
怎么开一百元五g流量包 100 金额	开通流量
开通一百元五g全国流量包 100 金额	开通流量
4g套餐一百元包五g数据流量如何开通 100 金额	开通流量
一百元包五g国内流量可以开通吗 100 金额	开通流量
帮我开通一百元五g国内流量包 100 金额	开通流量
开通一百元五g国内流量 100 金额	开通流量
你好请帮我把一百元国内流量包开通一下 100 金额	开通流量
我包一百元五g国内流量 100 金额	开通流量
开通一百元包全国的流量 100 金额	开通流量
一百元全国流量包怎么开通 100 金额	开通流量
开通一百元国内流量包月 100 金额	开通流量
我要开一百元五g国内流量 100 金额	开通流量
一百元国内流量包开通 100 金额	开通流量
如何开通一百元流量套餐 100 金额	开通流量
4g套餐一百元流量介绍 100 金额	开通流量
一百元国内流量开通 100 金额	开通流量
开通一百元五个g的流量 100 金额	开通流量
一百元流量套餐开通 100 金额	开通流量
一百元五g流量开通 100 金额	开通流量
开通一百元包全国流量 100 金额	开通流量
办理一百元五g流量包 100 金额	开通流量
一百元五g流量开通方式 100 金额	开通流量
开通一百元包国内五g套餐 100 金额	开通流量
一百元包五g流量包怎么开 100 金额	开通流量
一百元包五g国内流量包怎么办 100 金额	开通流量
开通一百元包国内五g 100 金额	开通流量
你们介绍的一百元五g怎么开通 100 金额	开通流量
请问有这个流量包吗每月一百元五g国内流量 100 金额	开通流量
一百元五g流量包介绍 100 金额	开通流量
怎么开通一百元包五g的业务 100 金额	开通流量
开通一百元包五g流量包 100 金额	开通流量
我想开通一百元五g的国内流量包应该咋办 100 金额	开通流量
一百元包多少流量怎么开通 100 金额	开通流量
一百元包多少流量 100 金额	开通流量
一百元包五g流量包 100 金额	开通流量
一百元五g是每月都能办吗 100 金额	开通流量
开通一百五十元包十g流量叠加包 150 金额	开通流量
开通的一百五十元十g 150 金额	开通流量
一百五十元4g流量包介绍 150 金额	开通流量
开通一百五十元十g流量包 150 金额	开通流量
一百五十元包十g 150 金额	开通流量
开通一百五十元十g套餐 150 金额	开通流量
怎样开通一百五十元十g流量业务 150 金额	开通流量
开通一百五十元包十g国内流量 150 金额	开通流量
如何开通一百五十元包十g流量 150 金额	开通流量
开通一百五十元包十g流量套餐 150 金额	开通流量
我想办理国内一百五十元十g 150 金额	开通流量
开通一百五十元包十g流量包 150 金额	开通流量
开个一百五十元包十g 150 金额	开通流量
一百元十g流量怎么办理 100 金额	开通流量
开通一百五十元流量叠加包 150 金额	开通流量
一百五十元包十g流量包介绍 150 金额	开通流量
一百五十元包十g国内 150 金额	开通流量
开通一百五十元十g流量套餐 150 金额	开通流量
怎样开通一百五十元十g国内流量 150 金额	开通流量
你好有一百五十元十g国内流量吗 150 金额	开通流量
如何开通一百五十元包十g国内流量 150 金额	开通流量
开通一百五十元包十g国内流量套餐 150 金额	开通流量
我想办理国内一百五十元十g的流量 150 金额	开通流量
有一百五十元十g的流量套餐吗 150 金额	开通流量
开个一百五十元包十g流量包 150 金额	开通流量
一百元十g流量包如何办理 100 金额	开通流量
一百元一个月十g流量的开通方式 100 金额	开通流量
怎么办一百五十元包十g国内流量 150 金额	开通流量
一百五十元包十g国内的流量套餐 150 金额	开通流量
二百元国内流量有吗 200 金额	开通流量
开通二百元包国内流量 200 金额	开通流量
麻烦开通二百元的流量包 200 金额	开通流量
开通二百元包十五g流量叠加包 200 金额	开通流量
开通一个二百元十五g 200 金额	开通流量
二百元4g流量包介绍 200 金额	开通流量
开通二百元十五g流量包 200 金额	开通流量
二百元包十五g 200 金额	开通流量
开通二百元十五g套餐 200 金额	开通流量
怎样开通二百元十五g流量业务 200 金额	开通流量
开通二百元包十五g国内流量 200 金额	开通流量
如何开通二百元包十五g流量 200 金额	开通流量
开通二百元包十五g流量套餐 200 金额	开通流量
我想办理国内二百元十五g 200 金额	开通流量
开通二百元包十五g流量包 200 金额	开通流量
开个二百元包十五g 200 金额	开通流量
一百元十五g流量怎么办理 100 金额	开通流量
怎么办二百元包十五g流量 200 金额	开通流量
开通二百元流量叠加包 200 金额	开通流量
二百元包十五g流量包介绍 200 金额	开通流量
二百元包十五g国内 200 金额	开通流量
开通二百元十五g流量套餐 200 金额	开通流量
怎样开通二百元十五g国内流量 200 金额	开通流量
你好有二百元十五g国内流量吗 200 金额	开通流量
如何开通二百元包十五g国内流量 200 金额	开通流量
开通二百元包十五g国内流量套餐 200 金额	开通流量
我想办理国内二百元十五g的流量 200 金额	开通流量
有二百元十五g的流量套餐吗 200 金额	开通流量
开个二百元包十五g流量包 200 金额	开通流量
一百元一个月十五g流量的开通方式 100 金额	开通流量
怎么办二百元包十五g国内流量 200 金额	开通流量
二百元包十五g国内的流量套餐 200 金额	开通流量
我要开通二百元省外流量包 200 金额	开通流量
三百元4g流量包介绍 300 金额	开通流量
4g飞享套餐国内版三百元国内流量可选包介绍 300 金额	开通流量
三百元包三十g流量 300 金额	开通流量
开通三百元三十g流量长期包 300 金额	开通流量
三百元三十g流量怎么办里 300 金额	开通流量
你好我想办三百元三十g的有吗 300 金额	开通流量
你好我定个三百元三十g的流量 300 金额	开通流量
老用户三百元包三十g流量怎么开 300 金额	开通流量
三百元三十g怎么开通 300 金额	开通流量
三百元三十g流量怎么开通 300 金额	开通流量
开通三百元三十g流量包 300 金额	开通流量
三百元三十g流量是每个月都可以办理吗 300 金额	开通流量
三百元开通多少流量 300 金额	开通流量
每月三百元包多少流量 300 金额	开通流量
是三百元包三十g的吗 300 金额	开通流量
三百元包三十g流量包 300 金额	开通流量
三百元国内流量包三十g 300 金额	开通流量
我可以办理三百元三十g流量吗 300 金额	开通流量
开通那个三百元包三十g流量那个 300 金额	开通流量
三百元流量套餐包有多少 300 金额	开通流量
三百元包三十个g 300 金额	开通流量
我可以开通三百元三十g流量套餐吗 300 金额	开通流量
我想办理三百元包三十g的套餐 300 金额	开通流量
三百元包三十g有吗 300 金额	开通流量
国内流量三百元三十g怎么办 300 金额	开通流量
三百元包三十g国内流量包 300 金额	开通流量
三百元包三十g 300 金额	开通流量
我想办三百元三十g的 300 金额	开通流量
帮我办一个三百元三十g的国内流量 300 金额	开通流量
怎么开通三百元开三十g流量 300 金额	开通流量
怎么开通三百元包三十g国内流量 300 金额	开通流量
开通十元一百兆流量 10 金额	开通流量
你能帮我开通一下十元一百兆的月流量包吗 10 金额	开通流量
我问一下有个二十元订三百兆国内流量我目前的套餐标准可以订吗 20 金额	开通流量
二十元国内三百兆流量包开通 20 金额	开通流量
二十元包国内流量三百兆 20 金额	开通流量
二十元包三百兆流量 20 金额	开通流量
二十元包三百兆流量开通 20 金额	开通流量
开通二十元包国内三百兆流量业务 20 金额	开通流量
开通一下二十元包国内三百兆 20 金额	开通流量
六元五百兆开通方式 6 金额	开通流量
帮我开通流量包六元五百兆 6 金额	开通流量
六元包五百兆流量 6 金额	开通流量
九元一g开通方式 9 金额	开通流量
九元包一g在哪个页面里 9 金额	开通流量
九元包一g流量 9 金额	开通流量
帮我十块钱的流量包取消了吧 10 金额	取消流量
十元的那个流量包不要了赶紧取消吧 10 金额	取消流量
十元的流量包可以取消吗我不想要了 10 金额	取消流量
取消一下十元的流量包 10 金额	取消流量
帮我取消十元流量包好吗 10 金额	取消流量
十元的流量包不是很想要了取消了吧 10 金额	取消流量
十块钱的流量包取消 10 金额	取消流量
你帮我十元的流量包取消了 10 金额	取消流量
十块钱的流量太少了我不要了取消了吧 10 金额	取消流量
我能不能取消流量包十元的呀 10 金额	取消流量
我的十元流量包可以取消吗 10 金额	取消流量
请取消十元的那个流量包 10 金额	取消流量
十元流量包取消一下 10 金额	取消流量
十元的流量包取消么么哒 10 金额	取消流量
取消十块钱的流量包 10 金额	取消流量
那个十块钱的流量包还能取消吗 10 金额	取消流量
十块钱流量包不要了赶紧给我弄没了 10 金额	取消流量
十元流量包帮我取消一下好吗 10 金额	取消流量
怎样才能取消十元的那个流量吗 10 金额	取消流量
你们这里是可以取消十元的流量包吗 10 金额	取消流量
十元的流量包我想取消 10 金额	取消流量
十元的流量包真的不想要了取消吧 10 金额	取消流量
取消十元流量包 10 金额	取消流量
十元流量包取消了 10 金额	取消流量
把我十元流量包取消 10 金额	取消流量
请取消我的十元流量包 10 金额	取消流量
请将我的十元流量包取消 10 金额	取消流量
我要取消十元流量包 10 金额	取消流量
我要将我的十元流量包取消掉 10 金额	取消流量
你能不能取消掉我的十元流量包 10 金额	取消流量
你可不可以取消我的十元流量包 10 金额	取消流量
请你帮我取消十元流量包 10 金额	取消流量
请帮我将十元流量包取消 10 金额	取消流量
我不要十元流量包了 10 金额	取消流量
我需要你帮我取消十元流量包 10 金额	取消流量
我需要将十元流量包取消 10 金额	取消流量
将我办理的十元流量包取消 10 金额	取消流量
请把我办理的十元流量包取消 10 金额	取消流量
我不需要十元流量包了 10 金额	取消流量
不需要十元流量包了 10 金额	取消流量
把十元流量包取消 10 金额	取消流量
把我的十元流量包给取消了 10 金额	取消流量
帮我二十块钱的流量包取消了吧 20 金额	取消流量
二十元的那个流量包不要了赶紧取消吧 20 金额	取消流量
二十元的流量包可以取消吗我不想要了 20 金额	取消流量
取消一下二十元的流量包 20 金额	取消流量
帮我取消二十元流量包好吗 20 金额	取消流量
二十元的流量包不是很想要了取消了吧 20 金额	取消流量
二十块钱的流量包取消 20 金额	取消流量
你帮我二十元的流量包取消了 20 金额	取消流量
二十块钱的流量太少了我不要了取消了吧 20 金额	取消流量
你能帮我取消一下二十元流量包 20 金额	取消流量
我能不能取消流量包二十元的呀 20 金额	取消流量
我的二十元流量包可以取消吗 20 金额	取消流量
请取消二十元的那个流量包 20 金额	取消流量
二十元流量包取消一下 20 金额	取消流量
二十元的流量包取消么么哒 20 金额	取消流量
取消二十块钱的流量包 20 金额	取消流量
那个二十块钱的流量包还能取消吗 20 金额	取消流量
二十块钱流量包不要了赶紧给我弄没了 20 金额	取消流量
二十元流量包帮我取消一下好吗 20 金额	取消流量
怎样才能取消二十元的那个流量吗 20 金额	取消流量
你们这里是可以取消二十元的流量包吗 20 金额	取消流量
二十元的流量包我想取消 20 金额	取消流量
二十元的流量包真的不想要了取消吧 20 金额	取消流量
取消二十元流量包 20 金额	取消流量
二十元流量包取消了 20 金额	取消流量
把我二十元流量包取消 20 金额	取消流量
请取消我的二十元流量包 20 金额	取消流量
请将我的二十元流量包取消 20 金额	取消流量
我要取消二十元流量包 20 金额	取消流量
我要将我的二十元流量包取消掉 20 金额	取消流量
你能不能取消掉我的二十元流量包 20 金额	取消流量
你可不可以取消我的二十元流量包 20 金额	取消流量
请你帮我取消二十元流量包 20 金额	取消流量
请帮我将二十元流量包取消 20 金额	取消流量
我不要二十元流量包了 20 金额	取消流量
我需要你帮我取消二十元流量包 20 金额	取消流量
我需要将二十元流量包取消 20 金额	取消流量
将我办理的二十元流量包取消 20 金额	取消流量
请把我办理的二十元流量包取消 20 金额	取消流量
我不需要二十元流量包了 20 金额	取消流量
不需要二十元流量包了 20 金额	取消流量
把二十元流量包取消 20 金额	取消流量
把我的二十元流量包给取消了 20 金额	取消流量
我要开通有个三十元的套餐 30 金额	办理套餐
我要开通有个三百元的套餐 300 金额	办理套餐
能给我开一个五元的流量不 5 金额	开通流量
能给我开一个六元的流量不 6 金额	开通流量
能给我开一个九元的流量不 9 金额	开通流量
二十元流量包开通 20 金额	开通流量
开通二十元流量 20 金额	开通流量
开通二十元流量包 20 金额	开通流量
开个二十元流量 20 金额	开通流量
能给我开一个二十元的流量不 20 金额	开通流量
怎么办理二十元流量包 20 金额	开通流量
能给我开一个七十元的流量不 70 金额	开通流量
能给我开一个一百元的流量不 100 金额	开通流量
能给我开一个一百五十元的流量不 150 金额	开通流量
有二百元的流量吗给我开一个 200 金额	开通流量
有二百元的流量包吗给我开一个 200 金额	开通流量
能给我开一个二百元的流量不 200 金额	开通流量
有三百元的流量吗给我开一个 300 金额	开通流量
有三百元的流量包吗给我开一个 300 金额	开通流量
能给我开一个三百元的流量不 300 金额	开通流量
十元流量包开通 10 金额	开通流量
开通十元流量包 10 金额	开通流量
开个十元流量 10 金额	开通流量
给我开个十块钱的流量 10 金额	开通流量
给我开个十块钱的流量包 10 金额	开通流量
有十元的流量吗给我开一个 10 金额	开通流量
有十元的流量包吗给我开一个 10 金额	开通流量
我要十元的流量 10 金额	开通流量
我要十元的流量包 10 金额	开通流量
我要十块钱的流量包 10 金额	开通流量
我要十块钱的流量 10 金额	开通流量
能给我开一个十元的流量不 10 金额	开通流量
可以给我开一个十块钱的流量包吗 10 金额	开通流量
我要一个十块钱的流量 10 金额	开通流量
我想买十块钱的流量 10 金额	开通流量
能给我开一个三十元的流量不 30 金额	开通流量
能给我开一个五十元的流量不 50 金额	开通流量
取消十元包国内流量套餐不是夜间的 10 金额	取消流量
嗯你好我要办理一百五十元基础套餐 150 金额	办理套餐
我要关闭十元流量包 10 金额	取消流量
有五十元的流量包吗 50 金额	开通流量
想退订二十元包三百兆流量包怎么办 20 金额	取消流量
我要关闭二十元流量包 20 金额	取消流量
退订我包的十元流量 10 金额	取消流量
取消二十元三百兆国内数据流量 20 金额	取消流量
我想取消二十元三百兆的那个流量 20 金额	取消流量
有二十元流量包吗 20 金额	开通流量
帮我把十元流量包关了 10 金额	取消流量
退订二十元流量 20 金额	取消流量
我要取消十元流量套餐 10 金额	取消流量
怎么取消十元一百兆全国流量包 10 金额	取消流量
怎么取消十元国内流量包 10 金额	取消流量
取消十块钱的流量业务 10 金额	取消流量
关闭十块钱的流量业务 10 金额	取消流量
取消二十块钱的流量业务 20 金额	取消流量
关闭二十块钱的流量业务 20 金额	取消流量
关闭我的十元流量 10 金额	取消流量
我想取消十元一百兆流量包 10 金额	取消流量
十元一百兆流量包取消 10 金额	取消流量
流量包二十元的如何取消 20 金额	取消流量
开通五十块钱包二g的流量包 50 金额	开通流量
开通一百元的普通流量包 100 金额	开通流量
我能办个二百元的流量包吗 200 金额	开通流量
能开个七十的流量包吗 70 金额	开通流量
二百元可以包多少流量 200 金额	开通流量
有没有三百元流量给我开一个 300 金额	开通流量
有三百元的流量吗 300 金额	开通流量
介绍一下十元流量包 10 金额	开通流量
我刚才交了五十块钱你看交上了吗 50 金额	查询充值缴费记录
三十基础流量 基础流量包 流量业务对象类型	流量
五十基础流量 基础流量包 流量业务对象类型	流量
七十基础流量 基础流量包 流量业务对象类型	流量
一百基础流量 基础流量包 流量业务对象类型	流量
一百五基础流量 基础流量包 流量业务对象类型	流量
一百五元基础流量包 基础流量包 流量业务对象类型	流量
二百基础流量 基础流量包 流量业务对象类型	流量
三百基础流量 基础流量包 流量业务对象类型	流量
五十元基础流量包短信方式是什么 基础流量包 流量业务对象类型	流量
七十元基础流量包包括什么 基础流量包 流量业务对象类型	流量
一百元基础流量包包括什么 基础流量包 流量业务对象类型	流量
三十元档基础流量数据 基础流量包 流量业务对象类型	流量
三十元4g基础流量包 基础流量包 流量业务对象类型	流量
手机上网三十元基础包 基础流量包 流量业务对象类型	流量
五十元基础流量套餐详情 基础流量包 流量业务对象类型	流量
五十元二g全国基础流量 基础流量包 流量业务对象类型	流量
五十元基础流量档次 基础流量包 流量业务对象类型	流量
五十元二g基础流量 基础流量包 流量业务对象类型	流量
4g套餐五十元国内基础流量 基础流量包 流量业务对象类型	流量
五十元是两个g的国内基础流量吗 基础流量包 流量业务对象类型	流量
五十元二g基础套餐 基础流量包 流量业务对象类型	流量
七十元基础流量 基础流量包 流量业务对象类型	流量
一百元五个g基础流量 基础流量包 流量业务对象类型	流量
一百五十元十g基础流量 基础流量包 流量业务对象类型	流量
一百五十元流量基础套餐 基础流量包 流量业务对象类型	流量
二百元十五g基础流量 基础流量包 流量业务对象类型	流量
二百元流量基础套餐 基础流量包 流量业务对象类型	流量
三百元基础流量套餐 基础流量包 流量业务对象类型	流量
三百元档基础流量数据 基础流量包 流量业务对象类型	流量
三百元4g基础流量包 基础流量包 流量业务对象类型	流量
三百元国内基础流量 基础流量包 流量业务对象类型	流量
三百元基础流量 基础流量包 流量业务对象类型	流量
手机上网三百元基础包 基础流量包 流量业务对象类型	流量
手机上网三百元基础流量包 基础流量包 流量业务对象类型	流量
一百五十基础流量 基础流量包 流量业务对象类型	流量
三十元流量加油包 加油包 流量业务对象类型	流量
六元五百兆省内流量加油包 加油包 流量业务对象类型	流量
流量加油包十元发送什么 加油包 流量业务对象类型	流量
二十元国内流量加油包 加油包 流量业务对象类型	流量
二十元的流量加油包 加油包 流量业务对象类型	流量
二十元普通流量加油包 加油包 流量业务对象类型	流量
二十元国内加油包给多少兆 加油包 流量业务对象类型	流量
二十元国内流量加油包包含多少流量 加油包 流量业务对象类型	流量
二十元一次性加油包 加油包 流量业务对象类型	流量
二十元国内流量加油 加油包 流量业务对象类型	流量
二十元加油套餐包 加油包 流量业务对象类型	流量
三十元国内流量加油包 加油包 流量业务对象类型	流量
三十元国内加油流量包 加油包 流量业务对象类型	流量
三十元加油流量 加油包 流量业务对象类型	流量
五十元流量加油包详情 加油包 流量业务对象类型	流量
五十元加油套餐包 加油包 流量业务对象类型	流量
国内十元流量加油包 加油包 流量业务对象类型	流量
十元流量加油包 加油包 流量业务对象类型	流量
十元国内加油包是怎么用的 加油包 流量业务对象类型	流量
十元一百兆加油包是一个月吗 加油包 流量业务对象类型	流量
十元国内流量加油包是多少啊 加油包 流量业务对象类型	流量
十元一百兆国内加油包 加油包 流量业务对象类型	流量
十元一次性加油包 加油包 流量业务对象类型	流量
十元数据流量加油包 加油包 流量业务对象类型	流量
十元加油包是国内流量吗 加油包 流量业务对象类型	流量
通用十元手机上网加油包 加油包 流量业务对象类型	流量
二十元三百兆加油包的活动 加油包 流量业务对象类型	流量
二十元三百兆流量加油包 加油包 流量业务对象类型	流量
二十元三百兆加油包 加油包 流量业务对象类型	流量
二十元数据流量加油包 加油包 流量业务对象类型	流量
二十元国内通用流量加油包 加油包 流量业务对象类型	流量
二十元流量加油包发送什么 加油包 流量业务对象类型	流量
二十元加油包是国内流量吗 加油包 流量业务对象类型	流量
二十元流量加油包全国的 加油包 流量业务对象类型	流量
二十元国内加油流量包 加油包 流量业务对象类型	流量
二十元加油流量 加油包 流量业务对象类型	流量
三十元国内五百兆流量加油包为什么是长期的 加油包 流量业务对象类型	流量
三十元数据流量加油包 加油包 流量业务对象类型	流量
三十元流量加油包发送什么 加油包 流量业务对象类型	流量
三十元加油包是国内流量吗 加油包 流量业务对象类型	流量
五十元流量加油包 加油包 流量业务对象类型	流量
五十元4g加油包 加油包 流量业务对象类型	流量
五十元国内流量加油包 加油包 流量业务对象类型	流量
五十元数据流量加油包 加油包 流量业务对象类型	流量
国内通用流量五十元加油包 加油包 流量业务对象类型	流量
五十元流量加油包发送什么 加油包 流量业务对象类型	流量
五十元流量加油包全国的 加油包 流量业务对象类型	流量
五十元国内加油流量包 加油包 流量业务对象类型	流量
五十元加油流量 加油包 流量业务对象类型	流量
好的十元日流量套餐 日流量包 流量业务对象类型	流量
十元日流量套餐是什么 日流量包 流量业务对象类型	流量
十元一g一天包 日流量包 流量业务对象类型	流量
十元一天一g国内流量包 日流量包 流量业务对象类型	流量
请问一天得十元一g的流量是一次性的吗 日流量包 流量业务对象类型	流量
十元一g一天流量包 日流量包 流量业务对象类型	流量
一天十元流量包 日流量包 流量业务对象类型	流量
十元一g一天国内的 日流量包 流量业务对象类型	流量
十元一g一天 日流量包 流量业务对象类型	流量
十元一g当天的 日流量包 流量业务对象类型	流量
十元一g当天有效吗 日流量包 流量业务对象类型	流量
十元一g国内二十4小时流量 日流量包 流量业务对象类型	流量
十元一g二十4小时 日流量包 流量业务对象类型	流量
十元一g国内流量二十4小时的 日流量包 流量业务对象类型	流量
六元五百兆小时包 小时流量包 流量业务对象类型	流量
六元小时流量补给包 小时流量包 流量业务对象类型	流量
九元小时流量补给包 小时流量包 流量业务对象类型	流量
六元小时套餐 小时流量包 流量业务对象类型	流量
六元五百兆小时流量 小时流量包 流量业务对象类型	流量
九元小时套餐 小时流量包 流量业务对象类型	流量
九元一g小时流量 小时流量包 流量业务对象类型	流量
九元一g小时包 小时流量包 流量业务对象类型	流量
4小时流量补给包 小时流量包 流量业务对象类型	流量
4小时流量套餐 小时流量包 流量业务对象类型	流量
4小时流量怎么用 小时流量包 流量业务对象类型	流量
4小时补给包多少钱 小时流量包 流量业务对象类型	流量
4小时流量包是什么时间段 小时流量包 流量业务对象类型	流量
国内4小时流量包 小时流量包 流量业务对象类型	流量
4小时包 小时流量包 流量业务对象类型	流量
国内4小时流量包什么意思 小时流量包 流量业务对象类型	流量
4小时流量包 小时流量包 流量业务对象类型	流量
4小时包和国庆包优先使用那一个 小时流量包 流量业务对象类型	流量
4小时流量包有效期 小时流量包 流量业务对象类型	流量
4小时流量包只能在4小时内使用吗 小时流量包 流量业务对象类型	流量
4小时补给包是省内还是国内 小时流量包 流量业务对象类型	流量
4小时快消包 小时流量包 流量业务对象类型	流量
4小时流量 小时流量包 流量业务对象类型	流量
4小时流量包生效了吗 小时流量包 流量业务对象类型	流量
4小时一g 小时流量包 流量业务对象类型	流量
4小时流量包优先使用吗 小时流量包 流量业务对象类型	流量
我的4小时流量包生效没有 小时流量包 流量业务对象类型	流量
也是什么我的4小时包不能用 小时流量包 流量业务对象类型	流量
我的4小时流量包怎么不显示剩余流量 小时流量包 流量业务对象类型	流量
4小时短时包发送短信 小时流量包 流量业务对象类型	流量
4个小时一g多少钱 小时流量包 流量业务对象类型	流量
这个4小时一g流量是不是立即使用的 小时流量包 流量业务对象类型	流量
4小时国内流量包 小时流量包 流量业务对象类型	流量
先用4小时流量包还是先用月套餐 小时流量包 流量业务对象类型	流量
这个4小时包是什么意思 小时流量包 流量业务对象类型	流量
请问4小时流量是什么意思 小时流量包 流量业务对象类型	流量
4小时五百兆 小时流量包 流量业务对象类型	流量
4个小时五百兆多少钱 小时流量包 流量业务对象类型	流量
4小时套餐 小时流量包 流量业务对象类型	流量
十元夜间上网套餐 夜间流量包 流量业务对象类型	流量
十元一g夜间流量包 夜间流量包 流量业务对象类型	流量
办理流量就这个月用 +0 月份	开通流量
我这月交的话费多不多呀 +0 月份	查询充值缴费记录
查下这个月的话费 +0 月份	查询账单
手机费这个月使多少 +0 月份	查询账单
这月话费扣多钱 +0 月份	查询账单
这月费用咋这么多 +0 月份	查询账单
这月消费这些 +0 月份	查询账单
这月都扣什么了 +0 月份	查询账单
我这个月充了多少钱 +0 月份	查询充值缴费记录
我这个月都缴了多少钱 +0 月份	查询充值缴费记录
我本月缴多少钱话费 +0 月份	查询充值缴费记录
你看我这个月充多少钱 +0 月份	查询充值缴费记录
这个月分钟够不够 +0 月份	查询语音
这月剩多些分钟了 +0 月份	查询语音
这月打多少分钟了 +0 月份	查询语音
本月有多少免费通话 +0 月份	查询语音
这个月分钟数剩多少 +0 月份	查询语音
我这月打多少分钟了 +0 月份	查询语音
这个月还剩多少分钟 +0 月份	查询语音
我这月分钟数还有多少 +0 月份	查询语音
这个月还多少分钟没打 +0 月份	查询语音
这个月还剩多少分钟了 +0 月份	查询语音
这个月通话时长还有多少 +0 月份	查询语音
这卡这个月还有多少分钟 +0 月份	查询语音
这个月的分钟数还有多少 +0 月份	查询语音
这个月流量还有多少 +0 月份	查询流量
这月短信还剩多少条 +0 月份	查询短信
我这个月还有剩余短信吗 +0 月份	查询短信
我这个月还有多少剩余的短信条数 +0 月份	查询短信
我这个月还剩多少短信 +0 月份	查询短信
我这个月短信还剩几条 +0 月份	查询短信
我这个月短信还剩多少条 +0 月份	查询短信
查一下这个月我还剩多少条短信 +0 月份	查询短信
查一下这个月还剩多少条短信 +0 月份	查询短信
查一下这个月短信还有多少条 +0 月份	查询短信
我有多少流量转到这个月 +0 月份	查询流量
这月都开通啥业务了 +0 月份	查询本机业务
我这个月扣了多少钱 +0 月份	查询账单
看我这个月交话费了吗 +0 月份	查询充值缴费记录
我上月话费记录 -1 月份	查询账单
查下上月的话费 -1 月份	查询账单
上月话费为什么花那么 -1 月份	查询账单
上月电话费用怎么扣了二十 -1 月份	查询账单
我有上个月结转的流量吗 -1 月份	查询流量
我有没有上个月剩余的流量 -1 月份	查询流量
我有没有上个月剩下来的流量 -1 月份	查询流量
上月结转流量有多少 -1 月份	查询流量
上个月结转过来多少流量 -1 月份	查询流量
查询上月剩余流量 -1 月份	查询流量
上月转接流量有哪些 -1 月份	查询流量
上月转接流量是哪些有多少 -1 月份	查询流量
我上个月交话费了吗 -1 月份	查询充值缴费记录
我上个月的消费 -1 月份	查询账单
我上个月交了多少钱 -1 月份	查询充值缴费记录
查一下我上个月交了多少钱 -1 月份	查询充值缴费记录
给我查一下十一月份的话费 11 月份	查询账单
二月份一共扣了多少钱 2 月份	查询账单
帮我把上个月的话费交一下 -1 月份	办理手机充值
看一下一月份的扣费情况 1 月份	查询账单
我上个月充值了多少话费 -1 月份	查询充值缴费记录
查一下我十二月份的扣费情况 12 月份	查询账单
我一月份的话费是怎么扣的 1 月份	查询账单
上个月共扣了多少钱 -1 月份	查询账单
一月份话费扣了多少 1 月份	查询账单
我上个月交过话费吗 -1 月份	查询充值缴费记录
给我看一下一月份话费怎么扣的 1 月份	查询账单
给我查一下上个月的话费怎么扣的 -1 月份	查询账单
我二月份交过话费吗 2 月份	查询充值缴费记录
五元包五百兆省内流量包二天包怎么用 5 金额	流量
五元五百兆两天包不会每两天都扣钱吧 5 金额	流量
请问4十八小时五元五百兆的流量包是如何扣费的 5 金额	流量
六元的就使用4个小时的怎么办理 6 金额	开通
九元办理4个小时 9 金额	开通
九元4小时急救包是不是通用流量 9 金额	流量
查询一下这个月的账单 +0 月份	查询账单
帮我查询下本月消费 +0 月份	查询账单
本月消费 +0 月份	查询账单
我这个月话费打了多少钱 +0 月份	查询账单
我这个月消费了多少钱 +0 月份	查询账单
我这个月是怎么消费的 +0 月份	查询账单
我这月交过话费吗 +0 月份	查询充值缴费记录
我这个月话费还剩多少 +0 月份	查询账单
我想查询一下本月话费 +0 月份	查询账单
本月消费情况 +0 月份	查询账单
这月花了多少钱 +0 月份	查询账单
这月扣什么钱了 +0 月份	查询账单
本月花了多少钱 +0 月份	查询账单
这个月花多少钱 +0 月份	查询账单
查询下本月账单 +0 月份	查询账单
这个月怎么收费的 +0 月份	查询账单
给我查下本月账单 +0 月份	查询账单
这个月消费什么 +0 月份	查询账单
我这月都扣啥钱 +0 月份	查询账单
我这月都花啥钱 +0 月份	查询账单
我本月花了多少钱 +0 月份	查询账单
这个月消费多少钱 +0 月份	查询账单
给我查查本月账单 +0 月份	查询账单
这个月花了什么钱 +0 月份	查询账单
我这个月花多少钱 +0 月份	查询账单
我这月花多少钱 +0 月份	查询账单
这月消费多少钱 +0 月份	查询账单
看下我这个月消费 +0 月份	查询账单
查询当月消费账单 +0 月份	查询账单
我这个月都哪扣费 +0 月份	查询账单
我这个月收多少钱 +0 月份	查询账单
查询本月的消费情况 +0 月份	查询账单
我这个月都花啥钱了 +0 月份	查询账单
我这个月钱怎么花的 +0 月份	查询账单
我这个月花了多少钱 +0 月份	查询账单
看看我这个月的消费 +0 月份	查询账单
我这月都花什么钱 +0 月份	查询账单
查一下这个月的消费 +0 月份	查询账单
看我这个月花了多钱 +0 月份	查询账单
我想查当月消费情况 +0 月份	查询账单
我这个月都花什么了 +0 月份	查询账单
我这个月怎么扣费的 +0 月份	查询账单
我这个月怎么消费的 +0 月份	查询账单
这个月都扣啥费了 +0 月份	查询账单
我本月都扣了多少钱 +0 月份	查询账单
我这个月咋收费的 +0 月份	查询账单
请看看我本月的消费 +0 月份	查询账单
这个月我都消费什么了 +0 月份	查询账单
这个月扣了什么费用 +0 月份	查询账单
这个月都扣我什么钱了 +0 月份	查询账单
看看这个月怎么消费的 +0 月份	查询账单
我这个月都花什么钱 +0 月份	查询账单
我这个月都花了什么钱 +0 月份	查询账单
这个月我花了多少钱 +0 月份	查询账单
我这个月怎么花的钱 +0 月份	查询账单
看看我这月都扣啥费了 +0 月份	查询账单
你看我这月消费多少钱 +0 月份	查询账单
我本月一共花了多少钱 +0 月份	查询账单
我这月使用多少话费了 +0 月份	查询账单
这个月都扣了什么费用 +0 月份	查询账单
我这个月都消费什么了 +0 月份	查询账单
我这个月都扣啥费 +0 月份	查询账单
我这个月都有哪些消费 +0 月份	查询账单
给我看看我这个月账单 +0 月份	查询账单
我这个月都有什么业务 +0 月份	查询本机业务
看我这个月花多少钱 +0 月份	查询账单
我这月话费怎么不对 +0 月份	查询账单
我这个月都扣什么钱 +0 月份	查询账单
我的这个月怎么消费的 +0 月份	查询账单
我想看看本月消费情况 +0 月份	查询账单
查查我这个月扣多少钱 +0 月份	查询账单
我这个月钱都花哪了 +0 月份	查询账单
看我本月都消费什么了 +0 月份	查询账单
这个月都消费了什么 +0 月份	查询账单
我这个月扣什么费用了 +0 月份	查询账单
我这月都扣什么费用了 +0 月份	查询账单
我这个月都什么消费 +0 月份	查询账单
本月我都消费了哪些钱 +0 月份	查询账单
这个月一共扣了多少钱 +0 月份	查询账单
这个月初扣了什么费用 +0 月份	查询月初扣费
查一下本月账单 +0 月份	查询账单
我这个月话费怎么扣的 +0 月份	查询账单
我这个月刚刚开始怎么扣的费 +0 月份	查询月初扣费
我这个月还能再发多少短信 +0 月份	查询短信
我这个月还能打多少分钟电话啊 +0 月份	查询语音
这个月花了多少钱 +0 月份	查询账单
我本月话费扣了多少 +0 月份	查询账单
一月份账单消费多少 1 月份	查询账单
我上个月消费了多少钱 -1 月份	查询账单
我上个月有没有交过话费 -1 月份	查询充值缴费记录
我八月份有没有交过话费 8 月份	查询充值缴费记录
我三月份有没有交过话费 3 月份	查询充值缴费记录
上个月话费扣了多少 -1 月份	查询账单
七十元的套餐如何办理 70 金额	办理套餐
一百元的套餐如何办理 100 金额	办理套餐
我想办三百元的这个套餐 300 金额	办理套餐
卡这个月还剩什么 +0 月份	查询套餐余量
单品宽带是什么 单品宽带 宽带类型	咨询宽带
我想知道单品宽带是什么 单品宽带 宽带类型	咨询宽带
单品宽带的价格 单品宽带 宽带类型	咨询宽带
帮我介绍下单品宽带的资费 单品宽带 宽带类型	咨询宽带
单品宽带有多少种 单品宽带 宽带类型	咨询宽带
单品宽带是怎么收费的 单品宽带 宽带类型	咨询宽带
单品宽带是什么你给我讲一下 单品宽带 宽带类型	咨询宽带
单品宽带可以给我介绍下吗 单品宽带 宽带类型	咨询宽带
能不能给我介绍下单品宽带 单品宽带 宽带类型	咨询宽带
单品宽带是什么宽带 单品宽带 宽带类型	咨询宽带
单品宽带是个什么东西 单品宽带 宽带类型	咨询宽带
单品宽带快么 单品宽带 宽带类型	咨询宽带
单品宽带怎么收钱的 单品宽带 宽带类型	咨询宽带
介绍下单品宽带 单品宽带 宽带类型	咨询宽带
介绍下你们移动的单品宽带 单品宽带 宽带类型	咨询宽带
你们移动的单品宽带是个什么玩意 单品宽带 宽带类型	咨询宽带
单品宽带给我介绍下 单品宽带 宽带类型	咨询宽带
帮我介绍下单品宽带 单品宽带 宽带类型	咨询宽带
群组宽带是什么 群组宽带 宽带类型	咨询宽带
我想知道群组宽带是什么 群组宽带 宽带类型	咨询宽带
群组宽带的价格 群组宽带 宽带类型	咨询宽带
帮我介绍下群组宽带的资费 群组宽带 宽带类型	咨询宽带
群组宽带有多少种 群组宽带 宽带类型	咨询宽带
群组宽带是怎么收费的 群组宽带 宽带类型	咨询宽带
群组宽带是什么你给我讲一下 群组宽带 宽带类型	咨询宽带
群组宽带可以给我介绍下吗 群组宽带 宽带类型	咨询宽带
能不能给我介绍下群组宽带 群组宽带 宽带类型	咨询宽带
群组宽带是什么宽带 群组宽带 宽带类型	咨询宽带
群组宽带是个什么东西 群组宽带 宽带类型	咨询宽带
群组宽带快么 群组宽带 宽带类型	咨询宽带
群组宽带怎么收钱的 群组宽带 宽带类型	咨询宽带
介绍下群组宽带 群组宽带 宽带类型	咨询宽带
介绍下你们移动的群组宽带 群组宽带 宽带类型	咨询宽带
你们移动的群组宽带是个什么玩意 群组宽带 宽带类型	咨询宽带
群组宽带给我介绍下 群组宽带 宽带类型	咨询宽带
帮我介绍下群组宽带 群组宽带 宽带类型	咨询宽带
介绍单品宽带 单品宽带 宽带类型	咨询宽带
办理群组宽带怎么收费 群组宽带 宽带类型	咨询宽带
单品宽带办理 单品宽带 宽带类型	预约宽带
单品宽带有什么档次的 单品宽带 宽带类型	咨询宽带
你们这儿单独安宽带多少钱 单品宽带 宽带类型	预约宽带
我的套餐上加个宽带怎么收费 4G融合宽带 宽带类型	预约宽带
我家里三个号码办理宽带怎么收费 群组宽带 宽带类型	预约宽带
三个号码一起办理宽带 群组宽带 宽带类型	预约宽带
群组资费宽带 群组宽带 宽带类型	咨询宽带
群组宽带是什么样的 群组宽带 宽带类型	咨询宽带
群组宽带的收费情况 群组宽带 宽带类型	咨询宽带
我忘记宽带密码了 密码 附属标签	重置宽带
重置我得宽带密码 密码 附属标签	重置宽带
帮我重置下宽带密码 密码 附属标签	重置宽带
忘记宽带密码重置 密码 附属标签	重置宽带
重置我宽带密码 密码 附属标签	重置宽带
将我的宽带密码重置了 密码 附属标签	重置宽带
忘记宽带密码了重置下 密码 附属标签	重置宽带
宽带密码不记得了重置下 密码 附属标签	重置宽带
能不能帮我重置下宽带密码 密码 附属标签	重置宽带
能不能帮我重置下我的宽带密码 密码 附属标签	重置宽带
可不可以帮我重置下我得宽带密码 密码 附属标签	重置宽带
可不可以帮我重置宽带密码 密码 附属标签	重置宽带
帮我重置我的这个什么宽带密码 密码 附属标签	重置宽带
我的宽带密码给我修改下 密码 附属标签	修改宽带
修改宽带密码 密码 附属标签	修改宽带
宽带密码修改下 密码 附属标签	修改宽带
能不能修改下我的宽带密码 密码 附属标签	修改宽带
我的宽带密码修改 密码 附属标签	修改宽带
给我的宽带密码改了 密码 附属标签	修改宽带
修改我的宽带密码 密码 附属标签	修改宽带
我的宽带密码改了 密码 附属标签	修改宽带
改宽带密码 密码 附属标签	修改宽带
修改一下我的宽带密码 密码 附属标签	修改宽带
我要换宽带密码 密码 附属标签	修改宽带
宽带密码改 密码 附属标签	修改宽带
帮我改宽带密码 密码 附属标签	修改宽带
帮我改一下宽带密码 密码 附属标签	修改宽带
帮我修改下宽带密码 密码 附属标签	修改宽带
帮我修改下我得宽带密码 密码 附属标签	修改宽带
帮我修改下我的宽带密码行不行 密码 附属标签	修改宽带
能不能帮我修改下我的宽带密码 密码 附属标签	修改宽带
改了我的宽带密码 密码 附属标签	修改宽带
怎么改宽带密码 密码 附属标签	修改宽带
修改下宽带密码 密码 附属标签	修改宽带
我这个有线宽带密码怎么改 密码 附属标签	修改宽带
我怎么修改宽带密码 密码 附属标签	修改宽带
我怎么改下宽带的密码 密码 附属标签	修改宽带
我怎么改我的宽带密码 密码 附属标签	修改宽带
我怎么改宽带密码 密码 附属标签	修改宽带
我有一个宽带怎么改密码 密码 附属标签	修改宽带
我要修改一下我的宽带密码 密码 附属标签	修改宽带
我要修改一下宽带密码 密码 附属标签	修改宽带
我要修改下宽带密码 密码 附属标签	修改宽带
我要修改宽带密码 密码 附属标签	修改宽带
我要修改宽带的密码 密码 附属标签	修改宽带
我要更改一下宽带密码 密码 附属标签	修改宽带
我要更改宽带密码 密码 附属标签	修改宽带
我要改一下我家宽带的密码 密码 附属标签	修改宽带
我要改一下宽带密码 密码 附属标签	修改宽带
我要改一下宽带的密码 密码 附属标签	修改宽带
我要改下宽带密码 密码 附属标签	修改宽带
我要改宽带密码 密码 附属标签	修改宽带
我要改个宽带密码 密码 附属标签	修改宽带
我要把宽带密码改一下 密码 附属标签	修改宽带
我想要修改我家的宽带密码 密码 附属标签	修改宽带
我想要修改宽带密码 密码 附属标签	修改宽带
我想要改个宽带密码 密码 附属标签	修改宽带
我想修改一下我的宽带密码 密码 附属标签	修改宽带
我想修改一下宽带密码 密码 附属标签	修改宽带
我想修改下我的宽带密码 密码 附属标签	修改宽带
我想修改下宽带密码 密码 附属标签	修改宽带
我想修改我家宽带密码 密码 附属标签	修改宽带
我想修改我的宽带密码 密码 附属标签	修改宽带
我想修改宽带密码 密码 附属标签	修改宽带
我想修改宽带登录密码 密码 附属标签	修改宽带
我想修改宽带的密码 密码 附属标签	修改宽带
我想修改家里宽带密码 密码 附属标签	修改宽带
我想修改个宽带密码 密码 附属标签	修改宽带
我想问一宽带密码怎么修改 密码 附属标签	修改宽带
我想换一下我的宽带密码 密码 附属标签	修改宽带
我想换一下宽带密码 密码 附属标签	修改宽带
我想换个宽带密码 密码 附属标签	修改宽带
我想更改一下宽带密码 密码 附属标签	修改宽带
我想更改一下宽带的密码 密码 附属标签	修改宽带
我想更改宽带密码 密码 附属标签	修改宽带
我想改一下密码宽带的 密码 附属标签	修改宽带
我想改一下宽带密码 密码 附属标签	修改宽带
我想改一下宽带的密码 密码 附属标签	修改宽带
我想改下宽带密码 密码 附属标签	修改宽带
我想改下宽带的密码 密码 附属标签	修改宽带
我想改我的宽带密码 密码 附属标签	修改宽带
我想改宽带密码 密码 附属标签	修改宽带
我想改宽带的密码 密码 附属标签	修改宽带
我想改个宽带密码 密码 附属标签	修改宽带
把我家的宽带密码修改一下 密码 附属标签	修改宽带
我想把宽带密码改一下 密码 附属标签	修改宽带
我现在修改宽带密码 密码 附属标签	修改宽带
修改一下我家里的宽带密码 密码 附属标签	修改宽带
我那个宽带密码怎么修改 密码 附属标签	修改宽带
我那个宽带密码能改一下 密码 附属标签	修改宽带
我宽带密码怎么修改 密码 附属标签	修改宽带
我宽带密码想修改 密码 附属标签	修改宽带
我宽带密码想换一个 密码 附属标签	修改宽带
我宽带密码想改一下 密码 附属标签	修改宽带
我家庭宽带密码想改一下 密码 附属标签	修改宽带
我家宽带密码怎么修改 密码 附属标签	修改宽带
我家宽带密码要更改一下 密码 附属标签	修改宽带
我家宽带密码需要修改一下 密码 附属标签	修改宽带
我家宽带密码想修改 密码 附属标签	修改宽带
我家宽带密码给我修改一下 密码 附属标签	修改宽带
我家宽带密码给我改一下 密码 附属标签	修改宽带
我家的宽带想改个密码 密码 附属标签	修改宽带
我家的宽带密码怎么修改 密码 附属标签	修改宽带
我的宽带密码怎么改 密码 附属标签	修改宽带
我的宽带密码想修改一下 密码 附属标签	修改宽带
我的宽带密码你帮我修改一下 密码 附属标签	修改宽带
我的宽带密码能在你这里修改 密码 附属标签	修改宽带
能不能把我宽带密码改一下 密码 附属标签	修改宽带
宽带想改一下密码 密码 附属标签	修改宽带
宽带密码怎么修改 密码 附属标签	修改宽带
宽带密码咋改 密码 附属标签	修改宽带
宽带密码修改一下 密码 附属标签	修改宽带
宽带密码能不能改一下 密码 附属标签	修改宽带
宽带密码能帮我改一下吗 密码 附属标签	修改宽带
给我修改一下宽带密码 密码 附属标签	修改宽带
给我修改宽带密码 密码 附属标签	修改宽带
给我宽带密码修改一下 密码 附属标签	修改宽带
给我宽带改个密码 密码 附属标签	修改宽带
给我换个宽带密码 密码 附属标签	修改宽带
给我改一下我家宽带密码 密码 附属标签	修改宽带
给我改一下我家的宽带密码 密码 附属标签	修改宽带
给我改一下宽带密码 密码 附属标签	修改宽带
给我改一下宽带的密码 密码 附属标签	修改宽带
给我改下宽带密码 密码 附属标签	修改宽带
改一下宽带密码 密码 附属标签	修改宽带
帮我修改一下宽带密码 密码 附属标签	修改宽带
帮我修改宽带密码 密码 附属标签	修改宽带
帮我修改个宽带密码 密码 附属标签	修改宽带
帮我更改一下宽带密码 密码 附属标签	修改宽带
帮我更改宽带密码 密码 附属标签	修改宽带
帮我改一下我家宽带密码 密码 附属标签	修改宽带
帮我改下我宽带密码 密码 附属标签	修改宽带
帮我改下宽带密码 密码 附属标签	修改宽带
帮我把宽带密码修改一下 密码 附属标签	修改宽带
帮我把宽带密码修改下 密码 附属标签	修改宽带
换一下宽带密码 密码 附属标签	修改宽带
重新设一下宽带密码 密码 附属标签	重置宽带
我想改一下我的宽带密码 密码 附属标签	修改宽带
宽带密码忘了重新设一个 密码 附属标签	重置宽带
改个宽带密码 密码 附属标签	修改宽带
帮我重新设置宽带密码 密码 附属标签	重置宽带
给我修改个宽带密码 密码 附属标签	修改宽带
宽带密码重置 密码 附属标签	重置宽带
我的宽带密码不知道了 密码 附属标签	重置宽带
我用身份证重新设置宽带密码 密码 附属标签	重置宽带
忘记宽带密码 密码 附属标签	重置宽带
宽带密码修改 密码 附属标签	修改宽带
改一下我的宽带密码 密码 附属标签	修改宽带
更换一下宽带密码 密码 附属标签	修改宽带
把我的宽带密码换一下 密码 附属标签	修改宽带
宽带改密码 密码 附属标签	修改宽带
宽带密码怎么改 密码 附属标签	修改宽带
我想给宽带换个密码 密码 附属标签	修改宽带
变更宽带密码 密码 附属标签	修改宽带
改掉原来的宽带密码 密码 附属标签	修改宽带
宽带密码给我变一个 密码 附属标签	修改宽带
你帮我重新弄一个宽带密码 密码 附属标签	重置宽带
重设上网密码 密码 附属标签	重置宽带
宽带密码忘记了怎么办 密码 附属标签	重置宽带
修改本机密码 密码 附属标签	修改手机
本机密码修改 密码 附属标签	修改手机
修改本机密钥 密码 附属标签	修改手机
本机密钥修改 密码 附属标签	修改手机
改本机密码 密码 附属标签	修改手机
本机密码改 密码 附属标签	修改手机
改本机密钥 密码 附属标签	修改手机
本机密钥改 密码 附属标签	修改手机
不记得了本机密码 密码 附属标签	重置手机
本机密码不记得了 密码 附属标签	重置手机
不记得了本机密钥 密码 附属标签	重置手机
本机密钥不记得了 密码 附属标签	重置手机
忘了本机密码 密码 附属标签	重置手机
本机密码忘了 密码 附属标签	重置手机
忘了本机密钥 密码 附属标签	重置手机
本机密钥忘了 密码 附属标签	重置手机
重置本机密码 密码 附属标签	重置手机
本机密码重置 密码 附属标签	重置手机
重置本机密钥 密码 附属标签	重置手机
本机密钥重置 密码 附属标签	重置手机
忘记了本机密码 密码 附属标签	重置手机
本机密码忘记了 密码 附属标签	重置手机
忘记了本机密钥 密码 附属标签	重置手机
本机密钥忘记了 密码 附属标签	重置手机
手机密钥改 密码 附属标签	修改手机
我能修改手机秘钥吗 密码 附属标签	修改手机
可以修改手机秘钥吗 密码 附属标签	修改手机
手机密钥不记得了 密码 附属标签	重置手机
手机密钥修改 密码 附属标签	修改手机
你好我能修改手机密码吗 密码 附属标签	修改手机
你好你能帮我修改手机密码吗 密码 附属标签	修改手机
你好请帮我修改手机密码 密码 附属标签	修改手机
服务密码怎么改 密码 附属标签	修改手机
怎么改服务密码 密码 附属标签	修改手机
怎样改服务密码 密码 附属标签	修改手机
手机服务密码在网上怎么修改 密码 附属标签	修改手机
我想改服务密码 密码 附属标签	修改手机
改服务密码 密码 附属标签	修改手机
手机客户端如何改服务密码 密码 附属标签	修改手机
我可以修改本手机号服务密码吗 密码 附属标签	修改手机
怎么改服务密码啊 密码 附属标签	修改手机
如何改服务密码 密码 附属标签	修改手机
帮我改下服务密码 密码 附属标签	修改手机
网上修改服务密码 密码 附属标签	修改手机
如何用身份证号修改服务密码 密码 附属标签	修改手机
服务密码在那里改 密码 附属标签	修改手机
服务密码在哪改 密码 附属标签	修改手机
改手机服务密码 密码 附属标签	修改手机
修改手机服务密码 密码 附属标签	修改手机
服务密码在哪里改 密码 附属标签	修改手机
怎么更改手机服务密码 密码 附属标签	修改手机
如何修改手机服务密码 密码 附属标签	修改手机
电脑在哪里更改服务密码 密码 附属标签	修改手机
想改一下服务密码 密码 附属标签	修改手机
怎么修改我的手机服务密码 密码 附属标签	修改手机
我想查一下我的手机短信服务密码怎么修改 密码 附属标签	修改手机
你好我怎么修改手机卡的服务密码 密码 附属标签	修改手机
这个服务密码怎么修改 密码 附属标签	修改手机
掌厅服务密码怎么改 密码 附属标签	修改手机
我的服务密码在哪里修改 密码 附属标签	修改手机
如何修改手机卡服务密码 密码 附属标签	修改手机
如何在app改服务密码 密码 附属标签	修改手机
修改手机服务密码怎么修改 密码 附属标签	修改手机
重置服务密码 密码 附属标签	重置手机
sim卡密码修改 密码 附属标签	修改手机
更改服务密码 密码 附属标签	修改手机
给我改个手机密码 密码 附属标签	修改手机
服务密码忘了 密码 附属标签	重置手机
重置手机密码 密码 附属标签	重置手机
手机密码忘了 密码 附属标签	重置手机
服务密码忘记了 密码 附属标签	重置手机
手机密码重置 密码 附属标签	重置手机
我服务密码忘了 密码 附属标签	重置手机
服务密码给忘了 密码 附属标签	重置手机
我手机密码忘了 密码 附属标签	重置手机
我的服务密码忘了 密码 附属标签	重置手机
重置新的服务密码 密码 附属标签	重置手机
重置一下卡的密码 密码 附属标签	重置手机
我的手机密码忘了 密码 附属标签	重置手机
我手机密码忘记了 密码 附属标签	重置手机
帮我改一下服务密码 密码 附属标签	修改手机
卡有没有初始的密码 密码 附属标签	重置手机
手机密码不知道咋整 密码 附属标签	重置手机
手机密码忘了怎么改 密码 附属标签	重置手机
我手机密码忘了咋整 密码 附属标签	重置手机
服务密码忘记了咋办 密码 附属标签	重置手机
服务密码忘了怎么重置 密码 附属标签	重置手机
怎么才能重置服务密码 密码 附属标签	重置手机
手机密码忘记了怎么办 密码 附属标签	重置手机
我手机密码忘了怎么办 密码 附属标签	重置手机
我不知道服务密码咋办 密码 附属标签	重置手机
请帮我重置新的服务密码 密码 附属标签	重置手机
重置这个手机的服务密码 密码 附属标签	重置手机
我服务密码忘了帮我看看 密码 附属标签	重置手机
手机密码没有了你发一个 密码 附属标签	重置手机
不知道服务密码 密码 附属标签	重置手机
我要改服务密码 密码 附属标签	修改手机
从新办手机密码 密码 附属标签	重置手机
手机密码怎么修改 密码 附属标签	修改手机
我要修改手机密码 密码 附属标签	修改手机
我想改下手机密码 密码 附属标签	修改手机
修改一下服务密码 密码 附属标签	修改手机
修改本卡服务密码 密码 附属标签	修改手机
我想修改手机密码 密码 附属标签	修改手机
想修改下手机密码 密码 附属标签	修改手机
我要改下手机密码 密码 附属标签	修改手机
我要更改服务密码 密码 附属标签	修改手机
帮我更改手机密码 密码 附属标签	修改手机
帮我改下手机密码 密码 附属标签	修改手机
帮我修改服务密码 密码 附属标签	修改手机
怎么修改手机密码 密码 附属标签	修改手机
我怎么修改手机密码 密码 附属标签	修改手机
我要改一下手机密码 密码 附属标签	修改手机
给我改一下服务密码 密码 附属标签	修改手机
帮我改一下手机密码 密码 附属标签	修改手机
我想修改下服务密码 密码 附属标签	修改手机
帮我修改下手机密码 密码 附属标签	修改手机
怎么修改服务密码 密码 附属标签	修改手机
帮我修改一下手机密码 密码 附属标签	修改手机
帮我把手机密码改一下 密码 附属标签	修改手机
帮我修改一下服务密码 密码 附属标签	修改手机
我怎么重置手机密码啊 密码 附属标签	重置手机
我想修改一下手机密码 密码 附属标签	修改手机
我现在要修改手机密码 密码 附属标签	修改手机
请帮我修改本卡的密码 密码 附属标签	修改手机
给我修改一下手机密码 密码 附属标签	修改手机
帮我修改下服务密码 密码 附属标签	修改手机
我的服务密码能修改吗 密码 附属标签	修改手机
我想修改我的手机密码 密码 附属标签	修改手机
怎么才能修改手机密码 密码 附属标签	修改手机
给我修改一下服务密码 密码 附属标签	修改手机
我能修改手机密码么 密码 附属标签	修改手机
给我手机密码修改一下 密码 附属标签	修改手机
帮我改下我的服务密码 密码 附属标签	修改手机
我想找回我的手机密码 密码 附属标签	重置手机
帮我把我的手机密码改一下吧 密码 附属标签	修改手机
手机密码忘了重新改一个 密码 附属标签	重置手机
改手机密码 密码 附属标签	修改手机
怎么重置我的服务密码 密码 附属标签	重置手机
能给我修改个服务密码吗 密码 附属标签	修改手机
重新设置一个手机密码 密码 附属标签	重置手机
给我改一下手机密码 密码 附属标签	修改手机
手机密码忘了重设一下 密码 附属标签	重置手机
重设手机密码 密码 附属标签	重置手机
重新设一个服务密码 密码 附属标签	重置手机
重设一下我的手机密码 密码 附属标签	重置手机
给我重新设一下服务密码 密码 附属标签	重置手机
给我充五十块钱话费 50 金额	办理手机充值
我想用银行卡充值 银行卡 附属标签	办理手机充值
我用银行卡能充话费吗 银行卡 附属标签	办理手机充值
帮我银行卡的方式充一下话费 银行卡 附属标签	办理手机充值
听说你们移动可以用银行卡充话费试试吧 银行卡 附属标签	办理手机充值
帮我用银行卡充话费吧 银行卡 附属标签	办理手机充值
银行卡充话费 银行卡 附属标签	办理手机充值
转入银行卡充话费 银行卡 附属标签	办理手机充值
给我充值话费用银行卡 银行卡 附属标签	办理手机充值
我要用银行卡农行卡给手机充点话费 银行卡 附属标签	办理手机充值
手机话费用银行卡充 银行卡 附属标签	办理手机充值
我能用银行卡给手机交点话费吗 银行卡 附属标签	办理手机充值
我能用银行卡给我交话费 银行卡 附属标签	办理手机充值
我要充话费银行卡方式 银行卡 附属标签	办理手机充值
给我用银行卡多充点话费 银行卡 附属标签	办理手机充值
用你们移动专用的充值卡给手机充话费 充值卡 附属标签	办理手机充值
我想用充值卡充值 充值卡 附属标签	办理手机充值
我用充值卡能充话费吗 充值卡 附属标签	办理手机充值
帮我充值卡的方式充一下话费 充值卡 附属标签	办理手机充值
听说你们移动可以用充值卡充话费试试吧 充值卡 附属标签	办理手机充值
帮我用充值卡充话费吧 充值卡 附属标签	办理手机充值
充值卡充话费 充值卡 附属标签	办理手机充值
给我充电话费用充值卡那种方式 充值卡 附属标签	办理手机充值
转入充值卡充话费 充值卡 附属标签	办理手机充值
我要用充值卡给手机充话费 充值卡 附属标签	办理手机充值
我想用充值卡给话费多充点 充值卡 附属标签	办理手机充值
给我充值话费用充值卡 充值卡 附属标签	办理手机充值
我要用充值卡给手机充点话费 充值卡 附属标签	办理手机充值
手机话费用充值卡充 充值卡 附属标签	办理手机充值
我能用充值卡给手机交点话费吗 充值卡 附属标签	办理手机充值
我想给手机交的话费用输充值卡号那种方式 充值卡 附属标签	办理手机充值
我能用充值卡给我交话费 充值卡 附属标签	办理手机充值
充值卡还能充话费吗赶紧给我充吧 充值卡 附属标签	办理手机充值
我要充话费充值卡方式 充值卡 附属标签	办理手机充值
给我用充值卡多充点话费 充值卡 附属标签	办理手机充值
可以用充值卡给手机充话费吗 充值卡 附属标签	办理手机充值
用银行卡交点电话费 银行卡 附属标签	办理手机充值
充值卡缴费 充值卡 附属标签	办理手机充值
银行卡充值 银行卡 附属标签	办理手机充值
用充值卡充值 充值卡 附属标签	办理手机充值
怎么用银行卡交话费 银行卡 附属标签	办理手机充值
充值卡怎么用 充值卡 附属标签	办理手机充值
用银行卡交话费 银行卡 附属标签	办理手机充值
我想当月包流量 +0 月份	开通流量
办理五十元流量包 50 金额	开通流量
开一个七十元的流量包 70 金额	开通流量
一百五十块钱的流量包怎么办理 150 金额	开通流量
开通一下一百五十块钱的流量包 150 金额	开通流量
办理一个三十元的流量包 30 金额	开通流量
开个三十元的流量 30 金额	开通流量
给我开个五十元的流量包 50 金额	开通流量
开通一下七十元的流量包 70 金额	开通流量
可以帮我手机办个一百元的流量吗 100 金额	开通流量
办一百元的流量 100 金额	开通流量
给我手机开个一百五十元的流量 150 金额	开通流量
我想办理一下二百元的流量 200 金额	开通流量
开三十元的流量包 30 金额	开通流量
帮我开五十块钱的流量包 50 金额	开通流量
包个七十元的流量 70 金额	开通流量
帮我订个一百元的流量 100 金额	开通流量
我想办一百五十元的流量 150 金额	开通流量
充五元流量 5 金额	开通流量
开通十元国内流量 10 金额	开通流量
开通七十元国内流量 70 金额	开通流量
七十元包国内流量包 70 金额	开通流量
三百元国内流量给我开通 300 金额	开通流量
怎么办理三百元国内流量包 300 金额	开通流量
办理一个三百元的流量包 300 金额	开通流量
我想办理个七十元的流量包 70 金额	开通流量
开通三十元的流量包 30 金额	开通流量
帮我订个一百元的流量包 100 金额	开通流量
我想办一百五十元的流量包 150 金额	开通流量
开通二十元的流量 20 金额	开通流量
三十元流量套餐如何开通 30 金额	开通流量
开通三十元流量包 30 金额	开通流量
三十元开通多少流量 30 金额	开通流量
三十元包多少流量 30 金额	开通流量
三十元包一个流量 30 金额	开通流量
三十元包流量一个月 30 金额	开通流量
开通那个三十元包一g流量那个 30 金额	开通流量
我可以开通三十元一g流量套餐吗 30 金额	开通流量
三十元流量套餐怎么办 30 金额	开通流量
我想办理三十元包一g的套餐 30 金额	开通流量
为什么给我开通三十元流量业务 30 金额	开通流量
三十元包国内流量 30 金额	开通流量
三十元包流量 30 金额	开通流量
怎么开通三十元开一g流量 30 金额	开通流量
怎么开通三十元开一g国内流量 30 金额	开通流量
我能开通三十元一g的套餐吗 30 金额	开通流量
开通三十元流量套餐 30 金额	开通流量
三十元国内流量包介绍 30 金额	开通流量
开通五十元国内流量套餐包 50 金额	开通流量
我定一个五十元流量 50 金额	开通流量
五十元可以包多少流量 50 金额	开通流量
五十元可以开多少国内流量 50 金额	开通流量
七十元流量套餐怎么办理 70 金额	开通流量
4g套餐七十元流量介绍 70 金额	开通流量
4g飞享套餐国内版七十元国内流量可选包介绍 70 金额	开通流量
七十元流量办理方式 70 金额	开通流量
开一个七十元国内流量包 70 金额	开通流量
七十元三g流量包介绍 70 金额	开通流量
4g套餐七十元包三g流量介绍 70 金额	开通流量
七十元国内流量套餐办理方式 70 金额	开通流量
七十元国内流量办理方式 70 金额	开通流量
七十元可以开多少国内流量 70 金额	开通流量
一百元国内流量怎么办理 100 金额	开通流量
一百元4g流量包介绍 100 金额	开通流量
怎么开一百元流量包 100 金额	开通流量
一百元国内流量办理方式 100 金额	开通流量
我想开通一百元国内数据流量怎么开通呢 100 金额	开通流量
开一个一百元国内流量包 100 金额	开通流量
把一百元的流量包开通 100 金额	开通流量
一百元包国内流量包 100 金额	开通流量
给我开通一百元的流量套餐 100 金额	开通流量
给我开通一百元的全国流量 100 金额	开通流量
一百元流量包怎么办理 100 金额	开通流量
开通一百五十元国内流量业务 150 金额	开通流量
开通一百五十元国内流量包 150 金额	开通流量
开通一百五十块钱的国内流量 150 金额	开通流量
怎么开通一百五十元国内流量包 150 金额	开通流量
二百元国内流量怎么办理 200 金额	开通流量
开通二百元国内流量 200 金额	开通流量
给我办理二百元流量套餐 200 金额	开通流量
开通二百元国内流量业务 200 金额	开通流量
我想开通二百元的流量包 200 金额	开通流量
开通二百元国内流量包 200 金额	开通流量
开通二百块钱的国内流量 200 金额	开通流量
怎么开通二百元国内流量包 200 金额	开通流量
开通三百元国内流量 300 金额	开通流量
三百元流量套餐如何开通 300 金额	开通流量
开通三百元流量包 300 金额	开通流量
三百元包一个流量 300 金额	开通流量
三百元流量套餐怎么办 300 金额	开通流量
怎么开通三百元流量业务 300 金额	开通流量
我要三百元的流量 300 金额	开通流量
三百元包流量 300 金额	开通流量
开通三百元流量套餐 300 金额	开通流量
三百元国内流量包介绍 300 金额	开通流量
三百元国内流量给我办理一下 300 金额	开通流量
我能开通三百元三十g的套餐吗 300 金额	开通流量
五元流量包开通 5 金额	开通流量
开通五元流量 5 金额	开通流量
开通五元流量包 5 金额	开通流量
开个五元流量 5 金额	开通流量
给我开个五块钱的流量 5 金额	开通流量
给我开个五块钱的流量包 5 金额	开通流量
有五元的流量吗给我开一个 5 金额	开通流量
有五元的流量包吗给我开一个 5 金额	开通流量
我要五元的流量 5 金额	开通流量
我要五元的流量包 5 金额	开通流量
我要五块钱的流量包 5 金额	开通流量
我要五块钱的流量 5 金额	开通流量
可以给我开一个五块钱的流量包吗 5 金额	开通流量
我要一个五块钱的流量 5 金额	开通流量
我想买五块钱的流量 5 金额	开通流量
六元流量包开通 6 金额	开通流量
开通六元流量 6 金额	开通流量
开通六元流量包 6 金额	开通流量
开个六元流量 6 金额	开通流量
给我开个六块钱的流量 6 金额	开通流量
给我开个六块钱的流量包 6 金额	开通流量
有六元的流量吗给我开一个 6 金额	开通流量
有六元的流量包吗给我开一个 6 金额	开通流量
我要六元的流量 6 金额	开通流量
我要六元的流量包 6 金额	开通流量
我要六块钱的流量包 6 金额	开通流量
我要六块钱的流量 6 金额	开通流量
可以给我开一个六块钱的流量包吗 6 金额	开通流量
我要一个六块钱的流量 6 金额	开通流量
我想买六块钱的流量 6 金额	开通流量
九元流量包开通 9 金额	开通流量
开通九元流量 9 金额	开通流量
开通九元流量包 9 金额	开通流量
开个九元流量 9 金额	开通流量
给我开个九块钱的流量 9 金额	开通流量
给我开个九块钱的流量包 9 金额	开通流量
有九元的流量吗给我开一个 9 金额	开通流量
有九元的流量包吗给我开一个 9 金额	开通流量
我要九元的流量 9 金额	开通流量
我要九元的流量包 9 金额	开通流量
我要九块钱的流量包 9 金额	开通流量
我要九块钱的流量 9 金额	开通流量
可以给我开一个九块钱的流量包吗 9 金额	开通流量
我要一个九块钱的流量 9 金额	开通流量
我想买九块钱的流量 9 金额	开通流量
给我开个二十块钱的流量 20 金额	开通流量
给我开个二十块钱的流量包 20 金额	开通流量
有二十元的流量吗给我开一个 20 金额	开通流量
有二十元的流量包吗给我开一个 20 金额	开通流量
我要二十元的流量 20 金额	开通流量
我要二十元的流量包 20 金额	开通流量
我要二十块钱的流量包 20 金额	开通流量
我要二十块钱的流量 20 金额	开通流量
可以给我开一个二十块钱的流量包吗 20 金额	开通流量
我要一个二十块钱的流量 20 金额	开通流量
我想买二十块钱的流量 20 金额	开通流量
七十元流量包开通 70 金额	开通流量
开个七十元流量 70 金额	开通流量
给我开个七十块钱的流量 70 金额	开通流量
给我开个七十块钱的流量包 70 金额	开通流量
有七十元的流量吗给我开一个 70 金额	开通流量
有七十元的流量包吗给我开一个 70 金额	开通流量
我要七十元的流量 70 金额	开通流量
我要七十元的流量包 70 金额	开通流量
我要七十块钱的流量包 70 金额	开通流量
我要七十块钱的流量 70 金额	开通流量
可以给我开一个七十块钱的流量包吗 70 金额	开通流量
我要一个七十块钱的流量 70 金额	开通流量
我想买七十块钱的流量 70 金额	开通流量
一百元流量包开通 100 金额	开通流量
开通一百元流量 100 金额	开通流量
开通一百元流量包 100 金额	开通流量
开个一百元流量 100 金额	开通流量
给我开个一百块钱的流量 100 金额	开通流量
给我开个一百块钱的流量包 100 金额	开通流量
有一百元的流量吗给我开一个 100 金额	开通流量
有一百元的流量包吗给我开一个 100 金额	开通流量
我要一百元的流量 100 金额	开通流量
我要一百元的流量包 100 金额	开通流量
我要一百块钱的流量包 100 金额	开通流量
我要一百块钱的流量 100 金额	开通流量
可以给我开一个一百块钱的流量包吗 100 金额	开通流量
我要一个一百块钱的流量 100 金额	开通流量
我想买一百块钱的流量 100 金额	开通流量
一百五十元流量包开通 150 金额	开通流量
开通一百五十元流量 150 金额	开通流量
开通一百五十元流量包 150 金额	开通流量
开个一百五十元流量 150 金额	开通流量
给我开个一百五十块钱的流量 150 金额	开通流量
给我开个一百五十块钱的流量包 150 金额	开通流量
有一百五十元的流量吗给我开一个 150 金额	开通流量
有一百五十元的流量包吗给我开一个 150 金额	开通流量
我要一百五十元的流量 150 金额	开通流量
我要一百五十元的流量包 150 金额	开通流量
我要一百五十块钱的流量包 150 金额	开通流量
我要一百五十块钱的流量 150 金额	开通流量
可以给我开一个一百五十块钱的流量包吗 150 金额	开通流量
我要一个一百五十块钱的流量 150 金额	开通流量
我想买一百五十块钱的流量 150 金额	开通流量
二百元流量包开通 200 金额	开通流量
开通二百元流量 200 金额	开通流量
开通二百元流量包 200 金额	开通流量
开个二百元流量 200 金额	开通流量
给我开个二百块钱的流量 200 金额	开通流量
给我开个二百块钱的流量包 200 金额	开通流量
我要二百元的流量 200 金额	开通流量
我要二百元的流量包 200 金额	开通流量
我要二百块钱的流量包 200 金额	开通流量
我要二百块钱的流量 200 金额	开通流量
可以给我开一个二百块钱的流量包吗 200 金额	开通流量
我要一个二百块钱的流量 200 金额	开通流量
我想买二百块钱的流量 200 金额	开通流量
三百元流量包开通 300 金额	开通流量
开通三百元流量 300 金额	开通流量
开个三百元流量 300 金额	开通流量
给我开个三百块钱的流量 300 金额	开通流量
给我开个三百块钱的流量包 300 金额	开通流量
我要三百元的流量包 300 金额	开通流量
我要三百块钱的流量包 300 金额	开通流量
我要三百块钱的流量 300 金额	开通流量
可以给我开一个三百块钱的流量包吗 300 金额	开通流量
我要一个三百块钱的流量 300 金额	开通流量
我想买三百块钱的流量 300 金额	开通流量
三十元流量包开通 30 金额	开通流量
开通三十元流量 30 金额	开通流量
开个三十元流量 30 金额	开通流量
给我开个三十块钱的流量 30 金额	开通流量
给我开个三十块钱的流量包 30 金额	开通流量
有三十元的流量吗给我开一个 30 金额	开通流量
有三十元的流量包吗给我开一个 30 金额	开通流量
我要三十元的流量 30 金额	开通流量
我要三十元的流量包 30 金额	开通流量
我要三十块钱的流量包 30 金额	开通流量
我要三十块钱的流量 30 金额	开通流量
可以给我开一个三十块钱的流量包吗 30 金额	开通流量
我要一个三十块钱的流量 30 金额	开通流量
我想买三十块钱的流量 30 金额	开通流量
五十元流量包开通 50 金额	开通流量
开通五十元流量 50 金额	开通流量
开通五十元流量包 50 金额	开通流量
开个五十元流量 50 金额	开通流量
给我开个五十块钱的流量 50 金额	开通流量
给我开个五十块钱的流量包 50 金额	开通流量
有五十元的流量吗给我开一个 50 金额	开通流量
有五十元的流量包吗给我开一个 50 金额	开通流量
我要五十元的流量 50 金额	开通流量
我要五十元的流量包 50 金额	开通流量
我要五十块钱的流量包 50 金额	开通流量
我要五十块钱的流量 50 金额	开通流量
可以给我开一个五十块钱的流量包吗 50 金额	开通流量
我要一个五十块钱的流量 50 金额	开通流量
我想买五十块钱的流量 50 金额	开通流量
你好请帮我开基础流量包 基础流量包 流量业务对象类型	开通流量
我想开基础流量包 基础流量包 流量业务对象类型	开通流量
变更基础流量套餐 基础流量包 流量业务对象类型	开通流量
基础流量套餐怎么修改 基础流量包 流量业务对象类型	开通流量
改基础流量套餐 基础流量包 流量业务对象类型	开通流量
你好我可以开基础流量包吗 基础流量包 流量业务对象类型	开通流量
我想开基础流量包怎么办 基础流量包 流量业务对象类型	开通流量
你能帮我开一个基础流量包吗 基础流量包 流量业务对象类型	开通流量
你好请帮我开流量加油 加油包 流量业务对象类型	开通流量
我想开流量加油 加油包 流量业务对象类型	开通流量
办理加油包 加油包 流量业务对象类型	开通流量
怎样定流量加油包 加油包 流量业务对象类型	开通流量
没流量了加油包 加油包 流量业务对象类型	查询流量
追加加油包 加油包 流量业务对象类型	开通流量
开通流量加油包 加油包 流量业务对象类型	开通流量
国内流量加油包怎么开 加油包 流量业务对象类型	开通流量
想办个加油包 加油包 流量业务对象类型	开通流量
我办一个流量加油包 加油包 流量业务对象类型	开通流量
办个流量加油包 加油包 流量业务对象类型	开通流量
想开加油包 加油包 流量业务对象类型	开通流量
想办国内流量的加油包 加油包 流量业务对象类型	开通流量
我想办加油包 加油包 流量业务对象类型	开通流量
想要流量加油包 加油包 流量业务对象类型	开通流量
我需要个加油包 加油包 流量业务对象类型	开通流量
我想办流量加油包 加油包 流量业务对象类型	开通流量
加油包我可以办吗 加油包 流量业务对象类型	开通流量
买流量加油包 加油包 流量业务对象类型	开通流量
我要个加油包怎么办 加油包 流量业务对象类型	开通流量
夜间流量加油包怎么开 加油包 流量业务对象类型	开通流量
我想包个加油包 加油包 流量业务对象类型	开通流量
流量加油包介绍 加油包 流量业务对象类型	开通流量
国内流量加油包介绍 加油包 流量业务对象类型	开通流量
怎么办理加油包 加油包 流量业务对象类型	开通流量
怎么包加油包 加油包 流量业务对象类型	开通流量
国内流量加油包怎么办理 加油包 流量业务对象类型	开通流量
你好我想办个加油包可以办什么样的 加油包 流量业务对象类型	开通流量
加油包怎么办 加油包 流量业务对象类型	开通流量
加油包怎么包 加油包 流量业务对象类型	开通流量
怎么办加油包 加油包 流量业务对象类型	开通流量
加油包怎么办理 加油包 流量业务对象类型	开通流量
流量加油包怎么办理 加油包 流量业务对象类型	开通流量
我想包加油包怎么包 加油包 流量业务对象类型	开通流量
包加油包怎么包 加油包 流量业务对象类型	开通流量
取消加油包 加油包 流量业务对象类型	取消流量
加油包取消了 加油包 流量业务对象类型	取消流量
把我加油包取消 加油包 流量业务对象类型	取消流量
请取消我的加油包 加油包 流量业务对象类型	取消流量
请将我的加油包取消 加油包 流量业务对象类型	取消流量
我要取消加油包 加油包 流量业务对象类型	取消流量
我要将我的加油包取消掉 加油包 流量业务对象类型	取消流量
你能不能取消掉我的加油包 加油包 流量业务对象类型	取消流量
你可不可以取消我的加油包 加油包 流量业务对象类型	取消流量
请你帮我取消加油包 加油包 流量业务对象类型	取消流量
请帮我将加油包取消 加油包 流量业务对象类型	取消流量
我不要加油包了 加油包 流量业务对象类型	取消流量
我需要你帮我取消加油包 加油包 流量业务对象类型	取消流量
我需要将加油包取消 加油包 流量业务对象类型	取消流量
将我办理的加油包取消 加油包 流量业务对象类型	取消流量
请把我办理的加油包取消 加油包 流量业务对象类型	取消流量
我不需要加油包了 加油包 流量业务对象类型	取消流量
不需要加油包了 加油包 流量业务对象类型	取消流量
把加油包取消 加油包 流量业务对象类型	取消流量
把我的加油包给取消了 加油包 流量业务对象类型	取消流量
如何取消夜间流量加油包 加油包 流量业务对象类型	取消流量
怎么取消闲时流量加油包 加油包 流量业务对象类型	取消流量
开通日流量包 日流量包 流量业务对象类型	开通流量
办理日流量包 日流量包 流量业务对象类型	开通流量
省外用的流量包天的怎么办的 日流量包 流量业务对象类型	开通流量
我想买一天的流量 日流量包 流量业务对象类型	开通流量
包一天的流量包 日流量包 流量业务对象类型	开通流量
小时流量包查询 小时流量包 流量业务对象类型	查询流量
查询小时流量包 小时流量包 流量业务对象类型	查询流量
小时流量包业务查询 小时流量包 流量业务对象类型	查询流量
查询小时流量包业务 小时流量包 流量业务对象类型	查询流量
进入小时流量包查询 小时流量包 流量业务对象类型	查询流量
进入查询小时流量包 小时流量包 流量业务对象类型	查询流量
进入小时流量包业务查询 小时流量包 流量业务对象类型	查询流量
进入查询小时流量包业务 小时流量包 流量业务对象类型	查询流量
查一下小时流量包 小时流量包 流量业务对象类型	查询流量
查一下小时流量包业务 小时流量包 流量业务对象类型	查询流量
查一下我的小时流量包 小时流量包 流量业务对象类型	查询流量
查一下我办理的小时流量包 小时流量包 流量业务对象类型	查询流量
开通国内夜间流量包 夜间流量包 流量业务对象类型	开通流量
怎么开通夜间流量 夜间流量包 流量业务对象类型	开通流量
夜间流量怎么开 夜间流量包 流量业务对象类型	开通流量
怎么开夜间流量 夜间流量包 流量业务对象类型	开通流量
开通夜间流量 夜间流量包 流量业务对象类型	开通流量
怎么办理夜间流量包 夜间流量包 流量业务对象类型	开通流量
订购夜间流量包 夜间流量包 流量业务对象类型	开通流量
夜间流量包办理 夜间流量包 流量业务对象类型	开通流量
夜间流量怎么打开 夜间流量包 流量业务对象类型	开通流量
办理夜间流量包 夜间流量包 流量业务对象类型	开通流量
怎么开通夜间流量包 夜间流量包 流量业务对象类型	开通流量
如何办理夜间流量 夜间流量包 流量业务对象类型	开通流量
我想问一下怎么定夜间流量 夜间流量包 流量业务对象类型	开通流量
夜间流量开通 夜间流量包 流量业务对象类型	开通流量
夜间流量怎么开通 夜间流量包 流量业务对象类型	开通流量
专用流量包开通夜间流量包 夜间流量包 流量业务对象类型	开通流量
夜间流量怎么订 夜间流量包 流量业务对象类型	开通流量
专用夜间流量怎么开 夜间流量包 流量业务对象类型	开通流量
夜间流量办理 夜间流量包 流量业务对象类型	开通流量
如何开夜间流量包 夜间流量包 流量业务对象类型	开通流量
开通个夜间包 夜间流量包 流量业务对象类型	开通流量
闲时流量包如何开通 夜间流量包 流量业务对象类型	开通流量
闲时流量怎么开通 夜间流量包 流量业务对象类型	开通流量
夜间流量在哪里办理 夜间流量包 流量业务对象类型	开通流量
请帮我开通夜间流量业务 夜间流量包 流量业务对象类型	开通流量
夜间流量套餐如何办理 夜间流量包 流量业务对象类型	开通流量
夜间流量包怎么开 夜间流量包 流量业务对象类型	开通流量
开通夜间流量包 夜间流量包 流量业务对象类型	开通流量
如何开通夜间流量包 夜间流量包 流量业务对象类型	开通流量
给我开个夜间流量包 夜间流量包 流量业务对象类型	开通流量
能给我开个夜间流量包吗 夜间流量包 流量业务对象类型	开通流量
夜间流量包怎么定 夜间流量包 流量业务对象类型	开通流量
夜间流量怎么能开通 夜间流量包 流量业务对象类型	开通流量
夜间流量包的办理方式 夜间流量包 流量业务对象类型	开通流量
我想开通夜间流量包怎么开 夜间流量包 流量业务对象类型	开通流量
可以开个夜间流量包吗 夜间流量包 流量业务对象类型	开通流量
怎么开通夜间流量套餐 夜间流量包 流量业务对象类型	开通流量
给我开通闲时流量包吧 夜间流量包 流量业务对象类型	开通流量
夜间包流量怎么开 夜间流量包 流量业务对象类型	开通流量
给我开通个夜间流量包 夜间流量包 流量业务对象类型	开通流量
怎么开通闲时流量套餐 夜间流量包 流量业务对象类型	开通流量
开通夜间包 夜间流量包 流量业务对象类型	开通流量
夜间流量怎么包 夜间流量包 流量业务对象类型	开通流量
怎么办夜间流量 夜间流量包 流量业务对象类型	开通流量
怎么包夜间流量 夜间流量包 流量业务对象类型	开通流量
夜间流量咋包 夜间流量包 流量业务对象类型	开通流量
夜间流量怎么办理 夜间流量包 流量业务对象类型	开通流量
夜间流量在哪开 夜间流量包 流量业务对象类型	开通流量
夜间流量包怎么办 夜间流量包 流量业务对象类型	开通流量
怎么办理夜间流量 夜间流量包 流量业务对象类型	开通流量
怎么买夜间流量啊 夜间流量包 流量业务对象类型	开通流量
我想买夜间流量应该怎么办理啊 夜间流量包 流量业务对象类型	开通流量
怎样开通夜间流量业务 夜间流量包 流量业务对象类型	开通流量
国内夜间流量包介绍 夜间流量包 流量业务对象类型	开通流量
把夜间套餐取消了吧 夜间流量包 流量业务对象类型	取消流量
怎么取消闲时流量包 夜间流量包 流量业务对象类型	取消流量
取消国内闲时包 夜间流量包 流量业务对象类型	取消流量
如何取消闲时流量 夜间流量包 流量业务对象类型	取消流量
请问如何取消闲时流量 夜间流量包 流量业务对象类型	取消流量
怎样取消闲时流量包 夜间流量包 流量业务对象类型	取消流量
取消全国流量闲时流量 夜间流量包 流量业务对象类型	取消流量
你好怎么取消夜间流量 夜间流量包 流量业务对象类型	取消流量
怎样取消夜间闲时流量 夜间流量包 流量业务对象类型	取消流量
怎么退订闲时流量包 夜间流量包 流量业务对象类型	取消流量
帮我把闲时流量包去掉 夜间流量包 流量业务对象类型	取消流量
全国流量闲时包怎么取消 夜间流量包 流量业务对象类型	取消流量
闲时流量怎么取消 夜间流量包 流量业务对象类型	取消流量
闲时流量取消 夜间流量包 流量业务对象类型	取消流量
怎么取消我套餐里的闲时流量包 夜间流量包 流量业务对象类型	取消流量
帮我取消闲时流量包 夜间流量包 流量业务对象类型	取消流量
闲时流量包可以取消吗 夜间流量包 流量业务对象类型	取消流量
怎样把订购的闲时流量包取消 夜间流量包 流量业务对象类型	取消流量
取消夜间闲时流量 夜间流量包 流量业务对象类型	取消流量
我要取消闲时流量 夜间流量包 流量业务对象类型	取消流量
怎么取消闲时流量 夜间流量包 流量业务对象类型	取消流量
取消夜间闲时包 夜间流量包 流量业务对象类型	取消流量
如何取消夜间闲时流量 夜间流量包 流量业务对象类型	取消流量
我的夜间闲时流量怎么取消 夜间流量包 流量业务对象类型	取消流量
开通的闲时流量包自动取消吗 夜间流量包 流量业务对象类型	取消流量
可以帮我把闲时流量取消吗 夜间流量包 流量业务对象类型	取消流量
闲时流量如何取消 夜间流量包 流量业务对象类型	取消流量
怎样取消闲时流量 夜间流量包 流量业务对象类型	取消流量
取消我的闲时流量包 夜间流量包 流量业务对象类型	取消流量
开通了闲时流量包可以取消吗 夜间流量包 流量业务对象类型	取消流量
闲时流量包月怎么取消 夜间流量包 流量业务对象类型	取消流量
我想把闲时流量取消 夜间流量包 流量业务对象类型	取消流量
能否取消闲时流量包 夜间流量包 流量业务对象类型	取消流量
取消国内闲时流量包 夜间流量包 流量业务对象类型	取消流量
你可以帮我取消闲时流量包吗 夜间流量包 流量业务对象类型	取消流量
怎样取消夜间流量 夜间流量包 流量业务对象类型	取消流量
取消夜间流量包 夜间流量包 流量业务对象类型	取消流量
怎么取消夜间流量 夜间流量包 流量业务对象类型	取消流量
如何取消夜间流量套餐 夜间流量包 流量业务对象类型	取消流量
夜间流量怎么取消 夜间流量包 流量业务对象类型	取消流量
取消夜间流量套餐 夜间流量包 流量业务对象类型	取消流量
怎么取消夜间流量包 夜间流量包 流量业务对象类型	取消流量
我想取消夜间流量包怎么办 夜间流量包 流量业务对象类型	取消流量
我想取消夜间流量包 夜间流量包 流量业务对象类型	取消流量
夜间流量包取消 夜间流量包 流量业务对象类型	取消流量
如何取消夜间流量包 夜间流量包 流量业务对象类型	取消流量
取消夜间包 夜间流量包 流量业务对象类型	取消流量
取消订购夜间流量包 夜间流量包 流量业务对象类型	取消流量
我想取消夜间流量套餐 夜间流量包 流量业务对象类型	取消流量
怎样取消国内夜间流量包 夜间流量包 流量业务对象类型	取消流量
想取消夜间流量包 夜间流量包 流量业务对象类型	取消流量
我的夜间流量怎么取消 夜间流量包 流量业务对象类型	取消流量
夜间流量包怎么取消 夜间流量包 流量业务对象类型	取消流量
取消国内夜间流量包 夜间流量包 流量业务对象类型	取消流量
取消国内夜间流量 夜间流量包 流量业务对象类型	取消流量
取消夜间套餐 夜间流量包 流量业务对象类型	取消流量
怎样取消夜间流量包 夜间流量包 流量业务对象类型	取消流量
取消夜间套餐业务 夜间流量包 流量业务对象类型	取消流量
怎么取消流量夜间包 夜间流量包 流量业务对象类型	取消流量
能帮我取消夜间流量包吗 夜间流量包 流量业务对象类型	取消流量
可以把夜间流量取消吗 夜间流量包 流量业务对象类型	取消流量
夜间流量取消 夜间流量包 流量业务对象类型	取消流量
我想取消夜间流量 夜间流量包 流量业务对象类型	取消流量
取消流量夜间包 夜间流量包 流量业务对象类型	取消流量
取消夜间流量怎么办 夜间流量包 流量业务对象类型	取消流量
能取消我的夜间流量吗 夜间流量包 流量业务对象类型	取消流量
怎么取消夜间流量套餐 夜间流量包 流量业务对象类型	取消流量
夜间流量套餐如何取消 夜间流量包 流量业务对象类型	取消流量
取消夜间流量包业务 夜间流量包 流量业务对象类型	取消流量
取消一个夜间流量包 夜间流量包 流量业务对象类型	取消流量
能帮我把夜间流量套餐取消吗 夜间流量包 流量业务对象类型	取消流量
如何取消夜间流量 夜间流量包 流量业务对象类型	取消流量
把我的夜间流量包取消了 夜间流量包 流量业务对象类型	取消流量
取消夜间流量业务 夜间流量包 流量业务对象类型	取消流量
怎么取消夜间包 夜间流量包 流量业务对象类型	取消流量
帮我把夜间流量取消下 夜间流量包 流量业务对象类型	取消流量
我想把夜间流量取消了 夜间流量包 流量业务对象类型	取消流量
怎么取消移动夜间流量包 夜间流量包 流量业务对象类型	取消流量
帮我把夜间流量取消一下 夜间流量包 流量业务对象类型	取消流量
怎样取消流量夜间包 夜间流量包 流量业务对象类型	取消流量
怎么取消夜间流量变成国内流量包 夜间流量包 流量业务对象类型	取消流量
夜间流量包取消服务 夜间流量包 流量业务对象类型	取消流量
帮我把夜间流量包取消 夜间流量包 流量业务对象类型	取消流量
夜间流量套餐怎么取消 夜间流量包 流量业务对象类型	取消流量
怎么取消国内夜间流量 夜间流量包 流量业务对象类型	取消流量
怎么取消夜间流量包月 夜间流量包 流量业务对象类型	取消流量
夜间流量业务取消 夜间流量包 流量业务对象类型	取消流量
夜间流量包如何取消 夜间流量包 流量业务对象类型	取消流量
能不能帮我取消夜间流量 夜间流量包 流量业务对象类型	取消流量
把夜间流量取消 夜间流量包 流量业务对象类型	取消流量
取消夜间包流量 夜间流量包 流量业务对象类型	取消流量
能不能帮我把夜间流量取消了 夜间流量包 流量业务对象类型	取消流量
可以帮我取消夜间流量么 夜间流量包 流量业务对象类型	取消流量
取消夜间流量包怎么取消 夜间流量包 流量业务对象类型	取消流量
能否取消夜间流量 夜间流量包 流量业务对象类型	取消流量
怎样取消包月夜间流量 夜间流量包 流量业务对象类型	取消流量
给我取消夜间流量 夜间流量包 流量业务对象类型	取消流量
我想退订夜间流量 夜间流量包 流量业务对象类型	取消流量
退夜间流量 夜间流量包 流量业务对象类型	取消流量
能帮我退订一下我的夜间流量包吗 夜间流量包 流量业务对象类型	取消流量
夜间流量包怎么退订 夜间流量包 流量业务对象类型	取消流量
退掉夜间流量包 夜间流量包 流量业务对象类型	取消流量
能不能退订夜间流量啊 夜间流量包 流量业务对象类型	取消流量
我想把夜间流量给退了 夜间流量包 流量业务对象类型	取消流量
我想把夜间流量退订怎么办 夜间流量包 流量业务对象类型	取消流量
退夜间流量包 夜间流量包 流量业务对象类型	取消流量
三十元基础流量包 基础流量包 流量业务对象类型	流量
五十元基础流量包 基础流量包 流量业务对象类型	流量
三十元基础流量套餐 基础流量包 流量业务对象类型	流量
三十元国内基础流量 基础流量包 流量业务对象类型	流量
三十元基础流量 基础流量包 流量业务对象类型	流量
五十元基础流量套餐 基础流量包 流量业务对象类型	流量
七十元基础流量包 基础流量包 流量业务对象类型	流量
五十元国内基础流量 基础流量包 流量业务对象类型	流量
五十元的国内基础流量 基础流量包 流量业务对象类型	流量
五十元的基础流量包 基础流量包 流量业务对象类型	流量
七十元基础流量套餐 基础流量包 流量业务对象类型	流量
一百元基础流量包 基础流量包 流量业务对象类型	流量
一百元的基础流量套餐 基础流量包 流量业务对象类型	流量
一百元基础流量 基础流量包 流量业务对象类型	流量
一百五十元基础流量包 基础流量包 流量业务对象类型	流量
二百元基础流量包 基础流量包 流量业务对象类型	流量
二百元的基础流量套餐 基础流量包 流量业务对象类型	流量
十元流量加油套餐 加油包 流量业务对象类型	流量
二十元流量加油套餐 加油包 流量业务对象类型	流量
三十元加油包 加油包 流量业务对象类型	流量
三十元流量加油套餐 加油包 流量业务对象类型	流量
五十元流量加油套餐 加油包 流量业务对象类型	流量
二十元国内流量包加油包 加油包 流量业务对象类型	流量
三十元国内流量加油 加油包 流量业务对象类型	流量
十元加油包 加油包 流量业务对象类型	流量
十元国内加油包 加油包 流量业务对象类型	流量
十元省外加油包 加油包 流量业务对象类型	流量
二十元加油包 加油包 流量业务对象类型	流量
二十元国内加油包 加油包 流量业务对象类型	流量
二十元临时加油包 加油包 流量业务对象类型	流量
二十元加油包流量 加油包 流量业务对象类型	流量
三十元国内加油包 加油包 流量业务对象类型	流量
三十元临时加油包 加油包 流量业务对象类型	流量
五十元加油包 加油包 流量业务对象类型	流量
五十元国内加油包 加油包 流量业务对象类型	流量
五十元临时加油包 加油包 流量业务对象类型	流量
五十元国内流量加油 加油包 流量业务对象类型	流量
五十元加油包流量 加油包 流量业务对象类型	流量
十元日流量套餐 日流量包 流量业务对象类型	流量
十元日流量套餐业务 日流量包 流量业务对象类型	流量
进入十元日流量套餐 日流量包 流量业务对象类型	流量
进入十元日流量套餐业务 日流量包 流量业务对象类型	流量
呃十元日流量套餐 日流量包 流量业务对象类型	流量
六元小时流量 小时流量包 流量业务对象类型	流量
小时流量包六元的 小时流量包 流量业务对象类型	流量
九元小时流量 小时流量包 流量业务对象类型	流量
小时流量包九元的 小时流量包 流量业务对象类型	流量
六元小时包 小时流量包 流量业务对象类型	流量
九元小时包 小时流量包 流量业务对象类型	流量
六元流量小时包 小时流量包 流量业务对象类型	流量
六块钱小时包 小时流量包 流量业务对象类型	流量
九元流量小时包 小时流量包 流量业务对象类型	流量
九块钱小时包 小时流量包 流量业务对象类型	流量
十元夜间流量包 夜间流量包 流量业务对象类型	流量
十元国内夜间包 夜间流量包 流量业务对象类型	流量
十元闲时流量包 夜间流量包 流量业务对象类型	流量
五元短时流量包 周末流量包 流量业务对象类型	流量
银行卡充一百块钱话费 银行卡 附属标签	办理手机充值
充值卡充一百块钱话费 充值卡 附属标签	办理手机充值
帮我开通本月夜间流量 夜间流量包 流量业务对象类型	开通流量
帮我取消下月夜间流量 夜间流量包 流量业务对象类型	取消流量
下个月不要二十元流量包了 20 金额	取消流量
三十元基础流量包开通 基础流量包 流量业务对象类型	开通流量
开通五十元基础流量包 基础流量包 流量业务对象类型	开通流量
办个五十元的基础流量 基础流量包 流量业务对象类型	开通流量
开通一百元基础流量包 基础流量包 流量业务对象类型	开通流量
一百元基础流量包开通 基础流量包 流量业务对象类型	开通流量
一百五元基础流量包开通 基础流量包 流量业务对象类型	开通流量
二百元基础流量包开通 基础流量包 流量业务对象类型	开通流量
三十元基础流量包怎么开通 基础流量包 流量业务对象类型	开通流量
三十元基础包怎么办理 基础流量包 流量业务对象类型	开通流量
三十元国内基础包介绍 基础流量包 流量业务对象类型	开通流量
开通二百元基础流量的方式 基础流量包 流量业务对象类型	开通流量
帮忙开通二百元基础流量包 基础流量包 流量业务对象类型	开通流量
把三十元基础流量包取消谢谢了 基础流量包 流量业务对象类型	取消流量
开通全国用的三十元加油包 加油包 流量业务对象类型	开通流量
开通十元国内流量加油包 加油包 流量业务对象类型	开通流量
开通二十元国内流量加油包 加油包 流量业务对象类型	开通流量
开通五十元加油包 加油包 流量业务对象类型	开通流量
开通4十元加油包 加油包 流量业务对象类型	开通流量
开通三十元加油包 加油包 流量业务对象类型	开通流量
开通二十元加油包 加油包 流量业务对象类型	开通流量
开通十元加油包 加油包 流量业务对象类型	开通流量
怎么办十元加油包流量 加油包 流量业务对象类型	开通流量
办十元加油包 加油包 流量业务对象类型	开通流量
十元包通用加油包 加油包 流量业务对象类型	开通流量
我要办十块钱的国内加油包 加油包 流量业务对象类型	开通流量
怎么买十元流量加油包 加油包 流量业务对象类型	开通流量
想办个十元全国加油包 加油包 流量业务对象类型	开通流量
开通流量加油包国内十元的 加油包 流量业务对象类型	开通流量
想办个十元加油包 加油包 流量业务对象类型	开通流量
如何开通十元加油包 加油包 流量业务对象类型	开通流量
办个十元流量加油包 加油包 流量业务对象类型	开通流量
想开十元加油包 加油包 流量业务对象类型	开通流量
流量加油包十块的怎么开通 加油包 流量业务对象类型	开通流量
想办十元国内流量的加油包 加油包 流量业务对象类型	开通流量
加油包我可以办吗十块钱的 加油包 流量业务对象类型	开通流量
买十元流量加油包 加油包 流量业务对象类型	开通流量
我要国内十元流量加油包 加油包 流量业务对象类型	开通流量
十元国内流量加油包开通 加油包 流量业务对象类型	开通流量
我想要十元一百兆流量加油包 加油包 流量业务对象类型	开通流量
十元包一百兆加油包怎么开通 加油包 流量业务对象类型	开通流量
我办一个十元流量加油包 加油包 流量业务对象类型	开通流量
十元国内流量加油包介绍 加油包 流量业务对象类型	开通流量
二十元国内流量加油包介绍 加油包 流量业务对象类型	开通流量
开通二十元国内加油包 加油包 流量业务对象类型	开通流量
开通二十元流量加油包 加油包 流量业务对象类型	开通流量
怎么买二十元流量加油包 加油包 流量业务对象类型	开通流量
怎么开通二十元加油包 加油包 流量业务对象类型	开通流量
怎样定二十元流量加油包 加油包 流量业务对象类型	开通流量
想办个二十元全国加油包 加油包 流量业务对象类型	开通流量
没流量了办个二十元加油包 加油包 流量业务对象类型	开通流量
给我开通二十元流量加油包 加油包 流量业务对象类型	开通流量
二十元国内流量加油包怎么开 加油包 流量业务对象类型	开通流量
二十元加油包怎么办 加油包 流量业务对象类型	开通流量
开通二十元流量加油包国内 加油包 流量业务对象类型	开通流量
想办个二十元加油包 加油包 流量业务对象类型	开通流量
怎么开通二十元省外流量加油包 加油包 流量业务对象类型	开通流量
我办一个二十元流量加油包 加油包 流量业务对象类型	开通流量
如何开通二十元加油包 加油包 流量业务对象类型	开通流量
办个二十元流量加油包 加油包 流量业务对象类型	开通流量
怎么办二十元加油包 加油包 流量业务对象类型	开通流量
想开二十元加油包 加油包 流量业务对象类型	开通流量
二十元流量加油包怎么开通 加油包 流量业务对象类型	开通流量
我想办二十元加油包 加油包 流量业务对象类型	开通流量
想要二十元流量加油包 加油包 流量业务对象类型	开通流量
我需要个二十元加油包 加油包 流量业务对象类型	开通流量
我想办二十元流量加油包 加油包 流量业务对象类型	开通流量
二十元加油包我可以办吗 加油包 流量业务对象类型	开通流量
买二十元流量加油包 加油包 流量业务对象类型	开通流量
我要个二十元加油包怎么办 加油包 流量业务对象类型	开通流量
我开通二十元三百兆加油包 加油包 流量业务对象类型	开通流量
开通三十元国内流量加油包 加油包 流量业务对象类型	开通流量
开通三十元国内加油包 加油包 流量业务对象类型	开通流量
三十元流量加油包介绍 加油包 流量业务对象类型	开通流量
我要办三十元国内加油包 加油包 流量业务对象类型	开通流量
给我开三十元加油包 加油包 流量业务对象类型	开通流量
开通三十元流量加油包 加油包 流量业务对象类型	开通流量
怎么开通三十元加油包 加油包 流量业务对象类型	开通流量
怎样定三十元流量加油包 加油包 流量业务对象类型	开通流量
想办个三十元全国加油包 加油包 流量业务对象类型	开通流量
三十元国内流量加油包怎么开 加油包 流量业务对象类型	开通流量
开通三十元流量加油包国内 加油包 流量业务对象类型	开通流量
想办个三十元加油包 加油包 流量业务对象类型	开通流量
如何开通三十元加油包 加油包 流量业务对象类型	开通流量
办个三十元流量加油包 加油包 流量业务对象类型	开通流量
想开三十元加油包 加油包 流量业务对象类型	开通流量
三十元流量加油包怎么开通 加油包 流量业务对象类型	开通流量
想办三十元国内流量的加油包 加油包 流量业务对象类型	开通流量
我想办三十元加油包 加油包 流量业务对象类型	开通流量
我需要个三十元加油包 加油包 流量业务对象类型	开通流量
三十元加油包我可以办吗 加油包 流量业务对象类型	开通流量
买三十元流量加油包 加油包 流量业务对象类型	开通流量
我要个三十元加油包怎么办 加油包 流量业务对象类型	开通流量
三十元加油包介绍 加油包 流量业务对象类型	开通流量
开通三十元国内的加油包 加油包 流量业务对象类型	开通流量
能开通三十元国内加油包 加油包 流量业务对象类型	开通流量
三十元加油包怎样定 加油包 流量业务对象类型	开通流量
五十元加油包开通吧 加油包 流量业务对象类型	开通流量
我要开通这个五十元加油包可以吗 加油包 流量业务对象类型	开通流量
我要五十元的加油包 加油包 流量业务对象类型	开通流量
我要办五十元国内加油包 加油包 流量业务对象类型	开通流量
怎么买五十元流量加油包 加油包 流量业务对象类型	开通流量
我想买个五十元加油包 加油包 流量业务对象类型	开通流量
给我开五十元加油包 加油包 流量业务对象类型	开通流量
开通五十元流量加油包 加油包 流量业务对象类型	开通流量
怎么开通五十元加油包 加油包 流量业务对象类型	开通流量
怎样定五十元流量加油包 加油包 流量业务对象类型	开通流量
没流量了加五十元加油包 加油包 流量业务对象类型	开通流量
想办个五十元全国加油包 加油包 流量业务对象类型	开通流量
没流量了办个五十元加油包 加油包 流量业务对象类型	开通流量
给我开通五十元流量加油包 加油包 流量业务对象类型	开通流量
五十元国内流量加油包怎么开 加油包 流量业务对象类型	开通流量
怎么办五十元加油包流量 加油包 流量业务对象类型	开通流量
五十元加油包怎么办 加油包 流量业务对象类型	开通流量
开通五十元流量加油包国内 加油包 流量业务对象类型	开通流量
想办个五十元加油包 加油包 流量业务对象类型	开通流量
我办一个五十元流量加油包 加油包 流量业务对象类型	开通流量
如何开通五十元加油包 加油包 流量业务对象类型	开通流量
办个五十元流量加油包 加油包 流量业务对象类型	开通流量
怎么办五十元加油包 加油包 流量业务对象类型	开通流量
五十元流量加油包怎么开通 加油包 流量业务对象类型	开通流量
想办五十元国内流量的加油包 加油包 流量业务对象类型	开通流量
我想办五十元加油包 加油包 流量业务对象类型	开通流量
想要五十元流量加油包 加油包 流量业务对象类型	开通流量
我需要个五十元加油包 加油包 流量业务对象类型	开通流量
我想办五十元流量加油包 加油包 流量业务对象类型	开通流量
五十元加油包我可以办吗 加油包 流量业务对象类型	开通流量
买五十元流量加油包 加油包 流量业务对象类型	开通流量
我要个五十元加油包怎么办 加油包 流量业务对象类型	开通流量
五十元流量加油包介绍 加油包 流量业务对象类型	开通流量
去省外开通个五十元加油包 加油包 流量业务对象类型	开通流量
我想包个三十元加油包 加油包 流量业务对象类型	开通流量
为什么十元加油包办不了 加油包 流量业务对象类型	开通流量
十元加油包订成功了吗 加油包 流量业务对象类型	开通流量
怎样定十元流量加油包 加油包 流量业务对象类型	开通流量
你好十元加油包怎么包 加油包 流量业务对象类型	开通流量
二十元国内流量加油包包多少 加油包 流量业务对象类型	开通流量
怎么包二十元加油包 加油包 流量业务对象类型	开通流量
怎么办二十元加油包流量 加油包 流量业务对象类型	开通流量
二十元加油包怎么包 加油包 流量业务对象类型	开通流量
加油包买有三十元的吗 加油包 流量业务对象类型	开通流量
怎么包三十元加油包 加油包 流量业务对象类型	开通流量
怎么办三十元加油包流量 加油包 流量业务对象类型	开通流量
三十元加油包怎么办 加油包 流量业务对象类型	开通流量
三十元加油包怎么包 加油包 流量业务对象类型	开通流量
怎么办三十元加油包 加油包 流量业务对象类型	开通流量
怎么办理三十元手机加油包 加油包 流量业务对象类型	开通流量
我想包三十元加油包怎么包 加油包 流量业务对象类型	开通流量
包加油包三十元怎么包 加油包 流量业务对象类型	开通流量
我想包个五十元加油包 加油包 流量业务对象类型	开通流量
怎么包五十元加油包 加油包 流量业务对象类型	开通流量
五十元加油包怎么包 加油包 流量业务对象类型	开通流量
我想包五十元加油包怎么包 加油包 流量业务对象类型	开通流量
包五十元加油包怎么包 加油包 流量业务对象类型	开通流量
十元日流量套餐办理 日流量包 流量业务对象类型	开通流量
办理十元日流量套餐 日流量包 流量业务对象类型	开通流量
进入十元日流量套餐办理 日流量包 流量业务对象类型	开通流量
进入办理十元日流量套餐 日流量包 流量业务对象类型	开通流量
查一下办理十元日流量套餐 日流量包 流量业务对象类型	开通流量
帮我办理十元日流量套餐 日流量包 流量业务对象类型	开通流量
呃十元日流量套餐办理 日流量包 流量业务对象类型	开通流量
十元日流量套餐介绍 日流量包 流量业务对象类型	开通流量
介绍介绍十元日流量套餐 日流量包 流量业务对象类型	开通流量
我怎么办理十元日流量包 日流量包 流量业务对象类型	开通流量
开通十元夜流量 夜间流量包 流量业务对象类型	开通流量
怎么开通十元国内夜间流量包 夜间流量包 流量业务对象类型	开通流量
十元夜间包流量怎么开 夜间流量包 流量业务对象类型	开通流量
十元夜间流量在哪里办理 夜间流量包 流量业务对象类型	开通流量
十元闲时流量是怎么办理的 夜间流量包 流量业务对象类型	开通流量
我不要十元夜间流量包了 夜间流量包 流量业务对象类型	取消流量
我不需要十元夜间流量包了 夜间流量包 流量业务对象类型	取消流量
不需要十元夜间流量包了 夜间流量包 流量业务对象类型	取消流量
我想取消十元包闲时流量 夜间流量包 流量业务对象类型	取消流量
怎么取消我的五元闲时流量业务 夜间流量包 流量业务对象类型	取消流量
五元闲时流量包如何取消 夜间流量包 流量业务对象类型	取消流量
怎么取消十元全国闲时流量包 夜间流量包 流量业务对象类型	取消流量
如何取消十元闲时流量 夜间流量包 流量业务对象类型	取消流量
取消十元国内夜间流量 夜间流量包 流量业务对象类型	取消流量
取消十元闲时夜间流量 夜间流量包 流量业务对象类型	取消流量
取消十元夜间流量 夜间流量包 流量业务对象类型	取消流量
取消十元国内夜间流量包 夜间流量包 流量业务对象类型	取消流量
我想把十元夜间包取消 夜间流量包 流量业务对象类型	取消流量
怎么取消十元夜间流量包 夜间流量包 流量业务对象类型	取消流量
十元夜间流量包怎么取消 夜间流量包 流量业务对象类型	取消流量
能取消十元夜间流量包吗 夜间流量包 流量业务对象类型	取消流量
怎么取消十元夜间流量 夜间流量包 流量业务对象类型	取消流量
十元的夜间流量包能否取消 夜间流量包 流量业务对象类型	取消流量
取消夜间包十元一个 夜间流量包 流量业务对象类型	取消流量
怎么退掉十元夜间流量 夜间流量包 流量业务对象类型	取消流量
退订十元夜间流量 夜间流量包 流量业务对象类型	取消流量
十元夜间流量包怎么去除 夜间流量包 流量业务对象类型	取消流量
十元加油包当月 加油包 流量业务对象类型	流量
六元4小时流量 小时流量包 流量业务对象类型	流量
国内六元流量包4小时 小时流量包 流量业务对象类型	开通流量
六元4小时流量套餐 小时流量包 流量业务对象类型	流量
国内九元流量包4小时 小时流量包 流量业务对象类型	开通流量
九元流量包4个小时 小时流量包 流量业务对象类型	开通流量
六元4小时国内流量包 小时流量包 流量业务对象类型	流量
六元4个小时的流量包 小时流量包 流量业务对象类型	流量
九元4小时流量 小时流量包 流量业务对象类型	流量
九元4小时流量套餐 小时流量包 流量业务对象类型	流量
九元4小时国内流量包 小时流量包 流量业务对象类型	流量
九元4个小时的流量包 小时流量包 流量业务对象类型	流量
有家庭成员合计一百元的宽带吗 群组宽带 宽带类型	咨询宽带
额办七十元基础流量套餐 基础流量包 流量业务对象类型	开通流量
办个二百的基础流量 基础流量包 流量业务对象类型	开通流量
六元小时流量包怎么办理 小时流量包 流量业务对象类型	开通流量
给我开通六元小时上网套餐 小时流量包 流量业务对象类型	开通流量
六元小时上网套餐开通 小时流量包 流量业务对象类型	开通流量
六元小时上网套餐办理 小时流量包 流量业务对象类型	开通流量
九元小时流量包怎么办理 小时流量包 流量业务对象类型	开通流量
给我开通九元小时上网套餐 小时流量包 流量业务对象类型	开通流量
九元小时上网套餐开通 小时流量包 流量业务对象类型	开通流量
九元小时上网套餐办理 小时流量包 流量业务对象类型	开通流量
十元日流量套餐查询 日流量包 流量业务对象类型	查询流量
十元日流量套餐业务查询 日流量包 流量业务对象类型	查询流量
查询十元日流量套餐业务 日流量包 流量业务对象类型	查询流量
进入十元日流量套餐查询 日流量包 流量业务对象类型	查询流量
进入查询十元日流量套餐 日流量包 流量业务对象类型	查询流量
进入十元日流量套餐业务查询 日流量包 流量业务对象类型	查询流量
进入查询十元日流量套餐业务 日流量包 流量业务对象类型	查询流量
查一下十元日流量套餐 日流量包 流量业务对象类型	查询流量
查一下我的十元日流量套餐 日流量包 流量业务对象类型	查询流量
查一下我办理的十元日流量套餐 日流量包 流量业务对象类型	查询流量
查一下我能办理的十元日流量套餐 日流量包 流量业务对象类型	查询流量
嗯十元日流量套餐都有哪些 日流量包 流量业务对象类型	开通流量
如何查询十元日流量套餐 日流量包 流量业务对象类型	查询流量
十元日流量套餐如何查询 日流量包 流量业务对象类型	查询流量
介绍十元日流量套餐办理 日流量包 流量业务对象类型	开通流量
给我开个三十的基础流量包 基础流量包 流量业务对象类型	开通流量
开通二十的加油包 加油包 流量业务对象类型	开通流量
办个五十的加油包 加油包 流量业务对象类型	开通流量
帮我开个九元国内小时包 小时流量包 流量业务对象类型	开通流量
给我开个十元日套餐 日流量包 流量业务对象类型	开通流量
帮我开通一个五元五百兆的省内流量短时包 周末流量包 流量业务对象类型	开通流量
开通三十元基础流量包 基础流量包 流量业务对象类型	开通流量
可以帮我把那个三十元基础流量开通吗 基础流量包 流量业务对象类型	开通流量
开通三十元国内基础流量 基础流量包 流量业务对象类型	开通流量
充五十元基础流量包 基础流量包 流量业务对象类型	开通流量
五十元基础流量包多少流量 基础流量包 流量业务对象类型	开通流量
办理五十元基础流量包 基础流量包 流量业务对象类型	开通流量
五十元包国内基础数据流量 基础流量包 流量业务对象类型	开通流量
五十元国内基础流量怎么办的 基础流量包 流量业务对象类型	开通流量
五十元基础流量包多少g的 基础流量包 流量业务对象类型	开通流量
五十元基础包可以包多少流量 基础流量包 流量业务对象类型	开通流量
给我开个五十元基础流量包 基础流量包 流量业务对象类型	开通流量
能开通个五十元的基础流量包吗 基础流量包 流量业务对象类型	开通流量
五十元基础流量包开通方式 基础流量包 流量业务对象类型	开通流量
开个五十元基础流量套餐 基础流量包 流量业务对象类型	开通流量
五十块钱基础流量包包多少流量 基础流量包 流量业务对象类型	开通流量
介绍下五十元的基础流量套餐包 基础流量包 流量业务对象类型	开通流量
五十元国内基础流量包介绍 基础流量包 流量业务对象类型	开通流量
开通七十元的国内基础流量包 基础流量包 流量业务对象类型	开通流量
开通七十元基础流量业务 基础流量包 流量业务对象类型	开通流量
我可以办理七十元基础流量包吗 基础流量包 流量业务对象类型	开通流量
七十元基础流量包怎么办理 基础流量包 流量业务对象类型	开通流量
开通七十元基础流量套餐 基础流量包 流量业务对象类型	开通流量
办理七十元三g的基础流量包 基础流量包 流量业务对象类型	开通流量
开通七十元国内基础流量 基础流量包 流量业务对象类型	开通流量
开通七十元三g的国内基础流量包 基础流量包 流量业务对象类型	开通流量
七十元基础流量开通方式 基础流量包 流量业务对象类型	开通流量
帮我开通七十元基础流量包 基础流量包 流量业务对象类型	开通流量
开通七十元三g基础流量包 基础流量包 流量业务对象类型	开通流量
七十元包三g基础流量包 基础流量包 流量业务对象类型	开通流量
开通七十元的基础流量包 基础流量包 流量业务对象类型	开通流量
开通七十元包全国基础流量 基础流量包 流量业务对象类型	开通流量
介绍下七十元的基础流量套餐包 基础流量包 流量业务对象类型	开通流量
4g套餐一百元基础流量办理方式 基础流量包 流量业务对象类型	开通流量
我要开通一百元的基础流量业务 基础流量包 流量业务对象类型	开通流量
开通一百元基础流量业务 基础流量包 流量业务对象类型	开通流量
怎样开通一百元基础流量包 基础流量包 流量业务对象类型	开通流量
开通一百元国内基础流量包 基础流量包 流量业务对象类型	开通流量
开通一百元基础流量 基础流量包 流量业务对象类型	开通流量
开通一百元的国内基础流量包 基础流量包 流量业务对象类型	开通流量
开通一百元包五g基础流量包 基础流量包 流量业务对象类型	开通流量
开通一百五十元基础流量包 基础流量包 流量业务对象类型	开通流量
开通一百五十元包十g基础流量包 基础流量包 流量业务对象类型	开通流量
一百五十元4g流量基础套餐介绍 基础流量包 流量业务对象类型	开通流量
我想开通一百五十元基础流量包 基础流量包 流量业务对象类型	开通流量
现在开通一百五十元基础流量包 基础流量包 流量业务对象类型	开通流量
怎样开通一百五十元省外基础流量包 基础流量包 流量业务对象类型	开通流量
我想开通一百五十元的基础流量怎么开通 基础流量包 流量业务对象类型	开通流量
怎么开通一百五十元国内基础流量包 基础流量包 流量业务对象类型	开通流量
如何开通一百五十元国内基础流量包 基础流量包 流量业务对象类型	开通流量
我想开一百五十元基础流量包怎么办 基础流量包 流量业务对象类型	开通流量
你能帮我开一个一百五十元基础流量包吗 基础流量包 流量业务对象类型	开通流量
开通个一百五十元国内基础流量 基础流量包 流量业务对象类型	开通流量
你好帮我开通一百五十元国内基础流量包 基础流量包 流量业务对象类型	开通流量
怎样开通一百五十元国内基础流量包 基础流量包 流量业务对象类型	开通流量
我这个套餐怎么加一百五十元基础流量 基础流量包 流量业务对象类型	开通流量
怎样开通一百五十元基础流量包 基础流量包 流量业务对象类型	开通流量
麻烦给开个一百五十元基础流量 基础流量包 流量业务对象类型	开通流量
开通一百五十元基础流量的方式 基础流量包 流量业务对象类型	开通流量
开通一百五十元流量基础包月 基础流量包 流量业务对象类型	开通流量
我要开通一百五十元省外基础流量包 基础流量包 流量业务对象类型	开通流量
如何开通一百五十元4g基础流量 基础流量包 流量业务对象类型	开通流量
怎样开通一百五十元4g基础流量包 基础流量包 流量业务对象类型	开通流量
办理一百五十元4g基础流量套餐 基础流量包 流量业务对象类型	开通流量
办理一百五十元4g基础流量包 基础流量包 流量业务对象类型	开通流量
一百五十元4g基础流量包办理 基础流量包 流量业务对象类型	开通流量
如何办理一百五十元4g基础流量套餐业务 基础流量包 流量业务对象类型	开通流量
一百五十元基础流量套餐开通 基础流量包 流量业务对象类型	开通流量
如何办理一百五十元基础流量套餐业务 基础流量包 流量业务对象类型	开通流量
一百五十元基础流量包办理 基础流量包 流量业务对象类型	开通流量
开通一下一百五十元基础流量套餐 基础流量包 流量业务对象类型	开通流量
帮忙开通一百五十元基础流量包 基础流量包 流量业务对象类型	开通流量
开通一下二百元基础流量包 基础流量包 流量业务对象类型	开通流量
开通二百元基础流量包 基础流量包 流量业务对象类型	开通流量
开通二百元包十五g基础流量包 基础流量包 流量业务对象类型	开通流量
我想开通二百元基础流量包 基础流量包 流量业务对象类型	开通流量
现在开通二百元基础流量包 基础流量包 流量业务对象类型	开通流量
怎样开通二百元省外基础流量包 基础流量包 流量业务对象类型	开通流量
我想开通二百元的基础流量怎么开通 基础流量包 流量业务对象类型	开通流量
怎么开通二百元国内基础流量包 基础流量包 流量业务对象类型	开通流量
如何开通二百元国内基础流量包 基础流量包 流量业务对象类型	开通流量
我想开二百元基础流量包怎么办 基础流量包 流量业务对象类型	开通流量
你能帮我开一个二百元基础流量包吗 基础流量包 流量业务对象类型	开通流量
开通个二百元国内基础流量 基础流量包 流量业务对象类型	开通流量
你好帮我开通二百元国内基础流量包 基础流量包 流量业务对象类型	开通流量
怎样开通二百元国内基础流量包 基础流量包 流量业务对象类型	开通流量
我这个套餐怎么加二百元基础流量 基础流量包 流量业务对象类型	开通流量
怎样开通二百元基础流量包 基础流量包 流量业务对象类型	开通流量
麻烦给开个二百元基础流量 基础流量包 流量业务对象类型	开通流量
开通二百元流量基础包月 基础流量包 流量业务对象类型	开通流量
如何开通二百元4g基础流量 基础流量包 流量业务对象类型	开通流量
怎样开通二百元4g基础流量包 基础流量包 流量业务对象类型	开通流量
办理二百元4g基础流量套餐 基础流量包 流量业务对象类型	开通流量
办理二百元4g基础流量包 基础流量包 流量业务对象类型	开通流量
二百元4g基础流量包办理 基础流量包 流量业务对象类型	开通流量
如何办理二百元4g基础流量套餐业务 基础流量包 流量业务对象类型	开通流量
二百元基础流量套餐开通 基础流量包 流量业务对象类型	开通流量
如何办理二百元基础流量套餐业务 基础流量包 流量业务对象类型	开通流量
二百元基础流量包办理 基础流量包 流量业务对象类型	开通流量
开通一下二百元基础流量套餐 基础流量包 流量业务对象类型	开通流量
三百元国内基础包介绍 基础流量包 流量业务对象类型	开通流量
开通三百元基础流量包 基础流量包 流量业务对象类型	开通流量
可以帮我把那个三百元基础流量开通吗 基础流量包 流量业务对象类型	开通流量
三百元4g基础流量包介绍 基础流量包 流量业务对象类型	开通流量
开通三百元国内基础流量 基础流量包 流量业务对象类型	开通流量
三百元包三十g的基础流量 基础流量包 流量业务对象类型	开通流量
三百元包基础流量 基础流量包 流量业务对象类型	开通流量
十元一g夜间流量怎么办理 夜间流量包 流量业务对象类型	开通流量
开通十元一g夜间流量包 夜间流量包 流量业务对象类型	开通流量
十元一g夜间流量如何办理 夜间流量包 流量业务对象类型	开通流量
十元一g夜间流量包如何办理 夜间流量包 流量业务对象类型	开通流量
订购夜间十元流量 夜间流量包 流量业务对象类型	开通流量
十元夜间流量包怎么开通 夜间流量包 流量业务对象类型	开通流量
怎么开十元一g的夜间流量套餐 夜间流量包 流量业务对象类型	开通流量
如何开通十元夜间流量包 夜间流量包 流量业务对象类型	开通流量
可以开通十元夜间流量包吗 夜间流量包 流量业务对象类型	开通流量
十元闲时流量包怎么开通 夜间流量包 流量业务对象类型	开通流量
给我开通十元夜间流量包吧 夜间流量包 流量业务对象类型	开通流量
十元夜间流量开通 夜间流量包 流量业务对象类型	开通流量
开通十元的夜间流量 夜间流量包 流量业务对象类型	开通流量
我办理十元加油包 加油包 流量业务对象类型	开通流量
开通十元一百兆加油包 加油包 流量业务对象类型	开通流量
十元国内流量加油包包多少 加油包 流量业务对象类型	开通流量
请问一下怎么办十元流量加油包 加油包 流量业务对象类型	开通流量
你好我想办理一个月十元的加油包 加油包 流量业务对象类型	开通流量
开通十元一次性加油包 加油包 流量业务对象类型	开通流量
你好我想办理一下十元国内流量加油包 加油包 流量业务对象类型	开通流量
我能办理十元加油包吗 加油包 流量业务对象类型	开通流量
十元加油包如何办理 加油包 流量业务对象类型	开通流量
十元加油包咋办理 加油包 流量业务对象类型	开通流量
办理十元国内加油包 加油包 流量业务对象类型	开通流量
十元国内加油包如何办理 加油包 流量业务对象类型	开通流量
二十元国内流量加油包怎么办理 加油包 流量业务对象类型	开通流量
二十元国内流量加油包怎么用短信开通 加油包 流量业务对象类型	开通流量
怎么办理二十元加油包 加油包 流量业务对象类型	开通流量
办理二十元加油包 加油包 流量业务对象类型	开通流量
办理二十元流量加油包 加油包 流量业务对象类型	开通流量
开通二十元一次性加油包 加油包 流量业务对象类型	开通流量
如何办理二十元流量加油包 加油包 流量业务对象类型	开通流量
办理二十元流量加油包一个月的 加油包 流量业务对象类型	开通流量
你好我想办理二十元加油包 加油包 流量业务对象类型	开通流量
你好我想开一个二十元流量加油包 加油包 流量业务对象类型	开通流量
我打算办个二十元流量加油包 加油包 流量业务对象类型	开通流量
我想办理二十元国内的流量加油包 加油包 流量业务对象类型	开通流量
二十元加油包办理 加油包 流量业务对象类型	开通流量
想办理个二十元加油包 加油包 流量业务对象类型	开通流量
二十元加油包怎么办理 加油包 流量业务对象类型	开通流量
我要办理二十元流量加油包 加油包 流量业务对象类型	开通流量
我想办理二十元加油包 加油包 流量业务对象类型	开通流量
二十元加油包咋办理 加油包 流量业务对象类型	开通流量
怎样办理二十元流量加油包 加油包 流量业务对象类型	开通流量
二十元包国内流量三百兆加油包 加油包 流量业务对象类型	开通流量
二十元包三百兆全国流量加油包 加油包 流量业务对象类型	开通流量
三十元加油包怎么办理 加油包 流量业务对象类型	开通流量
三十元加油包怎样办理 加油包 流量业务对象类型	开通流量
怎么办理三十元加油包 加油包 流量业务对象类型	开通流量
三十元国内流量加油包怎么办理 加油包 流量业务对象类型	开通流量
办理三十元流量加油包 加油包 流量业务对象类型	开通流量
如何办理三十元流量加油包 加油包 流量业务对象类型	开通流量
办理三十元流量加油包一个月的 加油包 流量业务对象类型	开通流量
你好我想办理三十元加油包 加油包 流量业务对象类型	开通流量
你好我想开一个三十元流量加油包 加油包 流量业务对象类型	开通流量
我打算办个三十元流量加油包 加油包 流量业务对象类型	开通流量
我想办理三十元国内的流量加油包 加油包 流量业务对象类型	开通流量
三十元加油包办理 加油包 流量业务对象类型	开通流量
想办理个三十元加油包 加油包 流量业务对象类型	开通流量
我要办理三十元流量加油包 加油包 流量业务对象类型	开通流量
三十元流量加油包怎么办理 加油包 流量业务对象类型	开通流量
我想办理三十元加油包 加油包 流量业务对象类型	开通流量
三十元加油包咋办理 加油包 流量业务对象类型	开通流量
怎样办理三十元流量加油包 加油包 流量业务对象类型	开通流量
开通三十元五百兆国内流量加油包 加油包 流量业务对象类型	开通流量
三十元流量加油包怎么办里 加油包 流量业务对象类型	开通流量
三十元国内五百兆流量加油包怎么开通 加油包 流量业务对象类型	开通流量
你好我要开通三十元加油包 加油包 流量业务对象类型	开通流量
三十元五百兆加油包开通方式 加油包 流量业务对象类型	开通流量
续一个三十元的加油包可以吗 加油包 流量业务对象类型	开通流量
三十元国内流量加油包介绍 加油包 流量业务对象类型	开通流量
开通五十元一g加油包 加油包 流量业务对象类型	开通流量
怎么办理五十元加油包 加油包 流量业务对象类型	开通流量
办理五十元加油包 加油包 流量业务对象类型	开通流量
五十元国内流量加油包怎么办理 加油包 流量业务对象类型	开通流量
如何办理五十元流量加油包 加油包 流量业务对象类型	开通流量
你好我想办理五十元加油包 加油包 流量业务对象类型	开通流量
我打算办个五十元流量加油包 加油包 流量业务对象类型	开通流量
我想办理五十元国内的流量加油包 加油包 流量业务对象类型	开通流量
有五十元流量加油包吗 加油包 流量业务对象类型	开通流量
五十元加油包办理 加油包 流量业务对象类型	开通流量
开通五十元一次性流量加油包 加油包 流量业务对象类型	开通流量
想办理个五十元加油包 加油包 流量业务对象类型	开通流量
有五十元国内流量加油包么 加油包 流量业务对象类型	开通流量
五十元加油包怎么办理 加油包 流量业务对象类型	开通流量
我要办理五十元流量加油包 加油包 流量业务对象类型	开通流量
五十元流量加油包怎么办理 加油包 流量业务对象类型	开通流量
我想办理五十元加油包 加油包 流量业务对象类型	开通流量
五十元加油包咋办理 加油包 流量业务对象类型	开通流量
怎样办理五十元流量加油包 加油包 流量业务对象类型	开通流量
怎么办理五十元手机加油包 加油包 流量业务对象类型	开通流量
我可以开五十元包一g的加油包吗 加油包 流量业务对象类型	开通流量
五十元一g流量加油包开通 加油包 流量业务对象类型	开通流量
我要开通五十元的加油包月 加油包 流量业务对象类型	开通流量
五十元加油包多少流量 加油包 流量业务对象类型	开通流量
我要开通五十元国内加油流量 加油包 流量业务对象类型	开通流量
五十元国内流量加油包介绍 加油包 流量业务对象类型	开通流量
怎么续五十元流量加油包 加油包 流量业务对象类型	开通流量
你好加油包五十元的怎么办理 加油包 流量业务对象类型	开通流量
你能直接给我开一个五十的加油包吗 加油包 流量业务对象类型	开通流量
我要开通4小时流量包 小时流量包 流量业务对象类型	开通流量
开通4小时流量包 小时流量包 流量业务对象类型	开通流量
刚才定的4小时限定流量什么时候到期 小时流量包 流量业务对象类型	开通流量
我想办理4小时流量套餐 小时流量包 流量业务对象类型	开通流量
请问4小时包怎么开通 小时流量包 流量业务对象类型	开通流量
申请4个小时流量包 小时流量包 流量业务对象类型	开通流量
4小时流量包短信怎么开通 小时流量包 流量业务对象类型	开通流量
我想包4小时流量 小时流量包 流量业务对象类型	开通流量
我想开通4小时流量 小时流量包 流量业务对象类型	开通流量
4小时流量包开通 小时流量包 流量业务对象类型	开通流量
国内4小时流量包怎么办理 小时流量包 流量业务对象类型	开通流量
国内流量包4小时 小时流量包 流量业务对象类型	开通流量
为什么办理了4小时流量包后还扣话费 小时流量包 流量业务对象类型	开通流量
4小时流量包怎么买 小时流量包 流量业务对象类型	开通流量
包那个4个小时的流量包需要多少钱 小时流量包 流量业务对象类型	开通流量
国内4小时流量包可以叠加吗 小时流量包 流量业务对象类型	开通流量
办理六元国内流量小时包 小时流量包 流量业务对象类型	开通流量
办理六块钱流量小时包 小时流量包 流量业务对象类型	开通流量
六元小时流量包开通方式 小时流量包 流量业务对象类型	开通流量
六元小时流量包开通 小时流量包 流量业务对象类型	开通流量
开通六元小时流量包 小时流量包 流量业务对象类型	开通流量
我要办理六元小时流量 小时流量包 流量业务对象类型	开通流量
开通一个六元小时流量包 小时流量包 流量业务对象类型	开通流量
六块钱小时流量包短信怎么开通 小时流量包 流量业务对象类型	开通流量
办理九元国内流量小时包 小时流量包 流量业务对象类型	开通流量
办理九块钱流量小时包 小时流量包 流量业务对象类型	开通流量
九元小时流量包开通方式 小时流量包 流量业务对象类型	开通流量
九元小时流量包开通 小时流量包 流量业务对象类型	开通流量
开通九元小时流量包 小时流量包 流量业务对象类型	开通流量
我要办理九元小时流量 小时流量包 流量业务对象类型	开通流量
开通一个九元小时流量包 小时流量包 流量业务对象类型	开通流量
九块钱小时流量包短信怎么开通 小时流量包 流量业务对象类型	开通流量
怎么开通国内九元小时流量包 小时流量包 流量业务对象类型	开通流量
能开通九元一g小时包吗 小时流量包 流量业务对象类型	开通流量
给我开通九元小时流量包 小时流量包 流量业务对象类型	开通流量
十元一g国内流量日套餐开通 日流量包 流量业务对象类型	开通流量
开通十元一g一天流量 日流量包 流量业务对象类型	开通流量
十元一天流量短信怎么开通 日流量包 流量业务对象类型	开通流量
有二十元流量加油包吗 加油包 流量业务对象类型	开通流量
怎么用发短信的方法开通十元一g日套餐 日流量包 流量业务对象类型	开通流量
怎么发短信开通十元一g一天的 日流量包 流量业务对象类型	开通流量
开通十元一g包一天的 日流量包 流量业务对象类型	开通流量
我只包一天的十元一g流量 日流量包 流量业务对象类型	开通流量
给我办理一个十元日套餐 日流量包 流量业务对象类型	开通流量
你给我开通一个十元日套餐 日流量包 流量业务对象类型	开通流量
我怎么办理十元一g日流量包 日流量包 流量业务对象类型	开通流量
一天包十元一g怎么办理 日流量包 流量业务对象类型	开通流量
开通一个全国十元一g一天的 日流量包 流量业务对象类型	开通流量
开通十元一g用一天的 日流量包 流量业务对象类型	开通流量
怎么开通十元一g一天的 日流量包 流量业务对象类型	开通流量
如何办理十元一g当天用的 日流量包 流量业务对象类型	开通流量
发短信怎么开通十元一g包天流量 日流量包 流量业务对象类型	开通流量
怎么发短信包十元一g短时流量 周末流量包 流量业务对象类型	开通流量
你好我想问问十元流量一天包的怎么办理 日流量包 流量业务对象类型	开通流量
给我开通一下十元一g一天 日流量包 流量业务对象类型	开通流量
你好帮我办一下十元一g一天包 日流量包 流量业务对象类型	开通流量
能开通十元一g一天包吗 日流量包 流量业务对象类型	开通流量
办一个十元一g一天包 日流量包 流量业务对象类型	开通流量
按天包的十元一g国内流量怎么办 日流量包 流量业务对象类型	开通流量
现在给我开通十元一g当天的 日流量包 流量业务对象类型	开通流量
如何短信办理十元一g单天流量 日流量包 流量业务对象类型	开通流量
你好周末这个五元五百兆的是不是我现在办理了就能立即生效使用了呢 周末流量包 流量业务对象类型	开通流量
在哪定五元周末流量 周末流量包 流量业务对象类型	开通流量
开周末两天短时包怎么办 周末流量包 流量业务对象类型	开通流量
有二天短时包吗 周末流量包 流量业务对象类型	开通流量
周末二天包是怎么开通 周末流量包 流量业务对象类型	开通流量
周末用的五元流量包开通一下 周末流量包 流量业务对象类型	开通流量
二天短时包怎么开通 周末流量包 流量业务对象类型	开通流量
周末二天用的怎么开通流量啊 周末流量包 流量业务对象类型	开通流量
有周末二天的短时包吗 周末流量包 流量业务对象类型	开通流量
一百五十元基础流量包开通 基础流量包 流量业务对象类型	开通流量
三十元4g基础流量包介绍 基础流量包 流量业务对象类型	开通流量
三十元包一g的基础流量 基础流量包 流量业务对象类型	开通流量
三十元包基础流量 基础流量包 流量业务对象类型	开通流量
介绍下五十元的基础流量包 基础流量包 流量业务对象类型	开通流量
五十元包国内基础流量 基础流量包 流量业务对象类型	开通流量
五十元基础流量是怎么包的 基础流量包 流量业务对象类型	开通流量
五十元包二g基础流量套餐 基础流量包 流量业务对象类型	开通流量
五十元的基础流量是怎么订购的 基础流量包 流量业务对象类型	开通流量
开通七十元基础数据流量 基础流量包 流量业务对象类型	开通流量
七十元国内基础流量包介绍 基础流量包 流量业务对象类型	开通流量
开通一百元国内基础流量 基础流量包 流量业务对象类型	开通流量
我想开通一百元五g的基础流量包应该咋办 基础流量包 流量业务对象类型	开通流量
我是省内4g卡如何开通一百五十元国内基础流量 基础流量包 流量业务对象类型	开通流量
有二百元的基础流量套餐吗 基础流量包 流量业务对象类型	开通流量
二百元4g流量基础套餐介绍 基础流量包 流量业务对象类型	开通流量
我是省内4g卡如何开通二百元国内基础流量 基础流量包 流量业务对象类型	开通流量
三百元基础包怎么办理 基础流量包 流量业务对象类型	开通流量
加油包买有十元的吗 加油包 流量业务对象类型	开通流量
开通十元包一百兆国内加油包 加油包 流量业务对象类型	开通流量
有没有十元加油包 加油包 流量业务对象类型	开通流量
如果每月都办理十元流量加油包有优惠吗 加油包 流量业务对象类型	开通流量
请问十元国内加油包今天办了什么时候到期 加油包 流量业务对象类型	开通流量
有没有十元的流量加油包 加油包 流量业务对象类型	开通流量
请问为什么没有十元一百兆的加油包了 加油包 流量业务对象类型	开通流量
有十元加油包 加油包 流量业务对象类型	开通流量
有十元加油包吗 加油包 流量业务对象类型	开通流量
有没有十元国内流量加油包 加油包 流量业务对象类型	开通流量
有十元国内流量加油包么 加油包 流量业务对象类型	开通流量
二十元流量加油包怎么发信息开通 加油包 流量业务对象类型	开通流量
二十元加油包有什么 加油包 流量业务对象类型	开通流量
加油包买有二十的吗 加油包 流量业务对象类型	开通流量
有二十元的加油包吗 加油包 流量业务对象类型	开通流量
有二十元加油包吗 加油包 流量业务对象类型	开通流量
有没有二十元国内流量加油包 加油包 流量业务对象类型	开通流量
有二十元国内流量加油包吗 加油包 流量业务对象类型	开通流量
有二十元全国流量加油包吗 加油包 流量业务对象类型	开通流量
二十元包三百兆加油包 加油包 流量业务对象类型	开通流量
我开通二十元包三百加油包 加油包 流量业务对象类型	开通流量
你好我开通二十元包三百兆加油套餐 加油包 流量业务对象类型	开通流量
开通三十元包国内五百兆流量加油包 加油包 流量业务对象类型	开通流量
怎么办理三十元包国内五百兆流量加油包 加油包 流量业务对象类型	开通流量
有三十元加油包吗 加油包 流量业务对象类型	开通流量
有三十元流量加油包吗 加油包 流量业务对象类型	开通流量
有没有三十元国内流量加油包 加油包 流量业务对象类型	开通流量
三十元加油包有吗 加油包 流量业务对象类型	开通流量
有三十元国内流量加油包么 加油包 流量业务对象类型	开通流量
有三十元国内流量加油包吗 加油包 流量业务对象类型	开通流量
三十元国内流量加油包有吗 加油包 流量业务对象类型	开通流量
有三十元全国流量加油包吗 加油包 流量业务对象类型	开通流量
短信如何开通三十元一次性加油包 加油包 流量业务对象类型	开通流量
办理一个三十元国内五百兆加油流量包 加油包 流量业务对象类型	开通流量
三十元包国内五百兆流量加油包开通 加油包 流量业务对象类型	开通流量
帮我开通三十元包国内五百兆流量加油包 加油包 流量业务对象类型	开通流量
加油包买有五十元的吗 加油包 流量业务对象类型	开通流量
有五十元加油包吗 加油包 流量业务对象类型	开通流量
有没有五十元国内流量加油包 加油包 流量业务对象类型	开通流量
五十元加油包有吗 加油包 流量业务对象类型	开通流量
五十元国内流量加油包有吗 加油包 流量业务对象类型	开通流量
有五十元全国流量加油包吗 加油包 流量业务对象类型	开通流量
流量不够用了加油包五十的包多少 加油包 流量业务对象类型	开通流量
能给我办一个加油包吗五十的 加油包 流量业务对象类型	开通流量
开通4小时快销包 小时流量包 流量业务对象类型	开通流量
4小时流量包介绍 小时流量包 流量业务对象类型	开通流量
九元小时流量包介绍 小时流量包 流量业务对象类型	开通流量
订购了4小时流量包怎么没显示 小时流量包 流量业务对象类型	开通流量
4元小时流量包介绍 小时流量包 流量业务对象类型	开通流量
可以给别人送4小时流量包吗 小时流量包 流量业务对象类型	开通流量
开通4小时加油包 加油包 流量业务对象类型	开通流量
有没有短信开通4小时流量包开通方式 小时流量包 流量业务对象类型	开通流量
办理了4小时流量的业务接着就可以使用了吗 小时流量包 流量业务对象类型	开通流量
买了4小时的流量是先用这个限时的流量还是用我本来的流量 小时流量包 流量业务对象类型	开通流量
我查一下我开的4小时流量包到什么时候啊 小时流量包 流量业务对象类型	查询流量
开通4小时流量包和原来没用完的流量套餐冲突吗 小时流量包 流量业务对象类型	开通流量
怎样用短信的方式开通4小时流量包啊 小时流量包 流量业务对象类型	开通流量
我定的4小时流量包为什么查不到 小时流量包 流量业务对象类型	查询流量
开通的4小时流量包怎么没有 小时流量包 流量业务对象类型	开通流量
4小时流量包发短信怎样开通呢 小时流量包 流量业务对象类型	开通流量
有4小时一g的流量吗 小时流量包 流量业务对象类型	开通流量
我开的4小时流量包怎么不能用 小时流量包 流量业务对象类型	开通流量
请问全国流量4小时的有没 小时流量包 流量业务对象类型	开通流量
这个4小时流量包可以叠加包吗 小时流量包 流量业务对象类型	开通流量
我省内流量没用完现在订购了4小时的国内流量加油包是不是能先用国内的 加油包 流量业务对象类型	开通流量
我刚刚订了一个4小时流量包为什么显示的是订了两个 小时流量包 流量业务对象类型	开通流量
我刚刚定的4小时流量包是否立即生效 小时流量包 流量业务对象类型	开通流量
为什么我不能办4小时流量包 小时流量包 流量业务对象类型	开通流量
开通4小时流量包就能用4小时 小时流量包 流量业务对象类型	开通流量
订的4小时流量包什么时候到 小时流量包 流量业务对象类型	开通流量
为什么我办不了4小时流量 小时流量包 流量业务对象类型	开通流量
我买了4个小时的流量包为什么不能用 小时流量包 流量业务对象类型	开通流量
我想开一个4个小时五百兆的流量包怎么开呢 小时流量包 流量业务对象类型	开通流量
开通4小时流量啥时候到 小时流量包 流量业务对象类型	开通流量
短信怎么办理4小时流量 小时流量包 流量业务对象类型	开通流量
有没有4小时的流量包 小时流量包 流量业务对象类型	开通流量
六元小时包介绍 小时流量包 流量业务对象类型	开通流量
有六元小时包吗 小时流量包 流量业务对象类型	开通流量
有4小时五百兆的流量吗 小时流量包 流量业务对象类型	开通流量
有六元小时包么 小时流量包 流量业务对象类型	开通流量
六元五百兆小时流量怎么发短信购买 小时流量包 流量业务对象类型	开通流量
六元小时流量包介绍 小时流量包 流量业务对象类型	开通流量
现在还有六元包五百兆小时套餐吗 小时流量包 流量业务对象类型	开通流量
开通六元小时流量补给包 小时流量包 流量业务对象类型	开通流量
短信怎么办理六元小时流量 小时流量包 流量业务对象类型	开通流量
有没有六元小时的流量包 小时流量包 流量业务对象类型	开通流量
包那个六元个小时的流量包需要怎么办理 小时流量包 流量业务对象类型	开通流量
国内六元小时流量包怎么办理 小时流量包 流量业务对象类型	开通流量
九元小时包介绍 小时流量包 流量业务对象类型	开通流量
有九元小时包吗 小时流量包 流量业务对象类型	开通流量
有九元小时包么 小时流量包 流量业务对象类型	开通流量
我想开一个4个小时一g的流量包怎么开呢 小时流量包 流量业务对象类型	开通流量
九元一g小时流量怎么发短信购买 小时流量包 流量业务对象类型	开通流量
现在还有九元包一g小时套餐吗 小时流量包 流量业务对象类型	开通流量
开通九元小时流量补给包 小时流量包 流量业务对象类型	开通流量
短信怎么办理九元小时流量 小时流量包 流量业务对象类型	开通流量
有没有九元小时的流量包 小时流量包 流量业务对象类型	开通流量
包那个九元个小时的流量包需要怎么办理 小时流量包 流量业务对象类型	开通流量
国内九元小时流量包怎么办理 小时流量包 流量业务对象类型	开通流量
有没有十元一g一天流量包 日流量包 流量业务对象类型	开通流量
十元一g流量日包是怎么办理 日流量包 流量业务对象类型	开通流量
我要充十元一g一天的 日流量包 流量业务对象类型	开通流量
办理十元一g的流量当天的 日流量包 流量业务对象类型	开通流量
全国十元一g用二十4小时的怎么开通 日流量包 流量业务对象类型	开通流量
十元一g流量包有没有全天的 日流量包 流量业务对象类型	开通流量
你好我想问问十元一g的流量一天包的怎么办理 日流量包 流量业务对象类型	开通流量
十元一g一天包开通 日流量包 流量业务对象类型	开通流量
我办理一个十元一g一天包 日流量包 流量业务对象类型	开通流量
一天天包的十元一g国内流量怎么办 日流量包 流量业务对象类型	开通流量
你好我这个可以办理十元一g一天包的么 日流量包 流量业务对象类型	开通流量
十元一g国内流量二十4小时失效的如何开通 日流量包 流量业务对象类型	开通流量
开通国内流量十元一g二十4小时是全国吗 日流量包 流量业务对象类型	开通流量
国内二十4小时流量包十元一g的那个怎么办理呢 日流量包 流量业务对象类型	开通流量
一天包十元一g是不是立即生效 日流量包 流量业务对象类型	开通流量
开通一个全国十元一g可以用二十4小时的 日流量包 流量业务对象类型	开通流量
十元一g是用一天吗是的话给我开一下 日流量包 流量业务对象类型	开通流量
开通一个十元一g一天的 日流量包 流量业务对象类型	开通流量
十元一g当天天用的怎么订购 日流量包 流量业务对象类型	开通流量
十元一g的流量一天的开通一下 日流量包 流量业务对象类型	开通流量
开通十元一g当天有效的 日流量包 流量业务对象类型	开通流量
你好十元一g的短时国内流量怎么开通 周末流量包 流量业务对象类型	开通流量
我想开通十元一g短时流量包 周末流量包 流量业务对象类型	开通流量
我要取消三十元的基础流量包 基础流量包 流量业务对象类型	取消流量
帮我取消三十元钱的流量包基础的 基础流量包 流量业务对象类型	取消流量
我的三十元基础包想取消掉 基础流量包 流量业务对象类型	取消流量
能不能取消三十元的基础流量包 基础流量包 流量业务对象类型	取消流量
操作取消三十元基础流量包 基础流量包 流量业务对象类型	取消流量
可以帮我把三十元基础流量包取消吗 基础流量包 流量业务对象类型	取消流量
你知道怎么取消三十元基础流量包吗 基础流量包 流量业务对象类型	取消流量
如何取消三十元的基础流量包 基础流量包 流量业务对象类型	取消流量
帮我把三十元的基础流量包取消了吧 基础流量包 流量业务对象类型	取消流量
我需要取消三十元的基础流量包 基础流量包 流量业务对象类型	取消流量
你知道取消三十元基础流量包的方法吗 基础流量包 流量业务对象类型	取消流量
三十元的基础流量包帮我取消了吧 基础流量包 流量业务对象类型	取消流量
取消基础流量包三十元的 基础流量包 流量业务对象类型	取消流量
三十元的基础流量包取消不要了 基础流量包 流量业务对象类型	取消流量
我能不能去下三十元的基础流量包 基础流量包 流量业务对象类型	取消流量
你能取消我的三十元基础流量包吗 基础流量包 流量业务对象类型	取消流量
怎样取消三十元的基础流量包 基础流量包 流量业务对象类型	取消流量
你赶紧帮我把基础流量包三十元的取消了吧 基础流量包 流量业务对象类型	取消流量
你这里能取消三十元的基础流量包吗 基础流量包 流量业务对象类型	取消流量
三十元的基础流量包取消一下 基础流量包 流量业务对象类型	取消流量
我办的那个三十的基础流量包取消不要了 基础流量包 流量业务对象类型	取消流量
基础流量包三十的取消了谢谢 基础流量包 流量业务对象类型	取消流量
三十的基础流量包不要了 基础流量包 流量业务对象类型	取消流量
可以取消三十元的基础流量包吗 基础流量包 流量业务对象类型	取消流量
我要取消五十元的基础流量包 基础流量包 流量业务对象类型	取消流量
帮我取消五十元钱的流量包基础的 基础流量包 流量业务对象类型	取消流量
我的五十元基础包想取消掉 基础流量包 流量业务对象类型	取消流量
能不能取消五十元的基础流量包 基础流量包 流量业务对象类型	取消流量
操作取消五十元基础流量包 基础流量包 流量业务对象类型	取消流量
可以帮我把五十元基础流量包取消吗 基础流量包 流量业务对象类型	取消流量
你知道怎么取消五十元基础流量包吗 基础流量包 流量业务对象类型	取消流量
如何取消五十元的基础流量包 基础流量包 流量业务对象类型	取消流量
帮我把五十元的基础流量包取消了吧 基础流量包 流量业务对象类型	取消流量
我需要取消五十元的基础流量包 基础流量包 流量业务对象类型	取消流量
你知道取消五十元基础流量包的方法吗 基础流量包 流量业务对象类型	取消流量
把五十元基础流量包取消谢谢了 基础流量包 流量业务对象类型	取消流量
五十元的基础流量包帮我取消了吧 基础流量包 流量业务对象类型	取消流量
取消基础流量包五十元的 基础流量包 流量业务对象类型	取消流量
五十元的基础流量包取消不要了 基础流量包 流量业务对象类型	取消流量
我能不能去下五十元的基础流量包 基础流量包 流量业务对象类型	取消流量
你能取消我的五十元基础流量包吗 基础流量包 流量业务对象类型	取消流量
怎样取消五十元的基础流量包 基础流量包 流量业务对象类型	取消流量
你赶紧帮我把基础流量包五十元的取消了吧 基础流量包 流量业务对象类型	取消流量
你这里能取消五十元的基础流量包吗 基础流量包 流量业务对象类型	取消流量
五十元的基础流量包取消一下 基础流量包 流量业务对象类型	取消流量
我办的那个五十的基础流量包取消不要了 基础流量包 流量业务对象类型	取消流量
基础流量包五十的取消了谢谢 基础流量包 流量业务对象类型	取消流量
五十的基础流量包不要了 基础流量包 流量业务对象类型	取消流量
可以取消五十元的基础流量包吗 基础流量包 流量业务对象类型	取消流量
我要取消七十元的基础流量包 基础流量包 流量业务对象类型	取消流量
帮我取消七十元钱的流量包基础的 基础流量包 流量业务对象类型	取消流量
我的七十元基础包想取消掉 基础流量包 流量业务对象类型	取消流量
能不能取消七十元的基础流量包 基础流量包 流量业务对象类型	取消流量
操作取消七十元基础流量包 基础流量包 流量业务对象类型	取消流量
可以帮我把七十元基础流量包取消吗 基础流量包 流量业务对象类型	取消流量
你知道怎么取消七十元基础流量包吗 基础流量包 流量业务对象类型	取消流量
如何取消七十元的基础流量包 基础流量包 流量业务对象类型	取消流量
帮我把七十元的基础流量包取消了吧 基础流量包 流量业务对象类型	取消流量
我需要取消七十元的基础流量包 基础流量包 流量业务对象类型	取消流量
你知道取消七十元基础流量包的方法吗 基础流量包 流量业务对象类型	取消流量
把七十元基础流量包取消谢谢了 基础流量包 流量业务对象类型	取消流量
七十元的基础流量包帮我取消了吧 基础流量包 流量业务对象类型	取消流量
取消基础流量包七十元的 基础流量包 流量业务对象类型	取消流量
七十元的基础流量包取消不要了 基础流量包 流量业务对象类型	取消流量
我能不能去下七十元的基础流量包 基础流量包 流量业务对象类型	取消流量
你能取消我的七十元基础流量包吗 基础流量包 流量业务对象类型	取消流量
怎样取消七十元的基础流量包 基础流量包 流量业务对象类型	取消流量
你赶紧帮我把基础流量包七十元的取消了吧 基础流量包 流量业务对象类型	取消流量
你这里能取消七十元的基础流量包吗 基础流量包 流量业务对象类型	取消流量
七十元的基础流量包取消一下 基础流量包 流量业务对象类型	取消流量
我办的那个七十的基础流量包取消不要了 基础流量包 流量业务对象类型	取消流量
基础流量包七十的取消了谢谢 基础流量包 流量业务对象类型	取消流量
七十的基础流量包不要了 基础流量包 流量业务对象类型	取消流量
可以取消七十元的基础流量包吗 基础流量包 流量业务对象类型	取消流量
我要取消一百元的基础流量包 基础流量包 流量业务对象类型	取消流量
帮我取消一百元钱的流量包基础的 基础流量包 流量业务对象类型	取消流量
我的一百元基础包想取消掉 基础流量包 流量业务对象类型	取消流量
能不能取消一百元的基础流量包 基础流量包 流量业务对象类型	取消流量
操作取消一百元基础流量包 基础流量包 流量业务对象类型	取消流量
可以帮我把一百元基础流量包取消吗 基础流量包 流量业务对象类型	取消流量
你知道怎么取消一百元基础流量包吗 基础流量包 流量业务对象类型	取消流量
如何取消一百元的基础流量包 基础流量包 流量业务对象类型	取消流量
帮我把一百元的基础流量包取消了吧 基础流量包 流量业务对象类型	取消流量
我需要取消一百元的基础流量包 基础流量包 流量业务对象类型	取消流量
你知道取消一百元基础流量包的方法吗 基础流量包 流量业务对象类型	取消流量
把一百元基础流量包取消谢谢了 基础流量包 流量业务对象类型	取消流量
一百元的基础流量包帮我取消了吧 基础流量包 流量业务对象类型	取消流量
取消基础流量包一百元的 基础流量包 流量业务对象类型	取消流量
一百元的基础流量包取消不要了 基础流量包 流量业务对象类型	取消流量
我能不能去下一百元的基础流量包 基础流量包 流量业务对象类型	取消流量
你能取消我的一百元基础流量包吗 基础流量包 流量业务对象类型	取消流量
怎样取消一百元的基础流量包 基础流量包 流量业务对象类型	取消流量
你赶紧帮我把基础流量包一百元的取消了吧 基础流量包 流量业务对象类型	取消流量
你这里能取消一百元的基础流量包吗 基础流量包 流量业务对象类型	取消流量
一百元的基础流量包取消一下 基础流量包 流量业务对象类型	取消流量
我办的那个一百的基础流量包取消不要了 基础流量包 流量业务对象类型	取消流量
基础流量包一百的取消了谢谢 基础流量包 流量业务对象类型	取消流量
一百的基础流量包不要了 基础流量包 流量业务对象类型	取消流量
可以取消一百元的基础流量包吗 基础流量包 流量业务对象类型	取消流量
我要取消一百五十元的基础流量包 基础流量包 流量业务对象类型	取消流量
帮我取消一百五十元钱的流量包基础的 基础流量包 流量业务对象类型	取消流量
我的一百五十元基础包想取消掉 基础流量包 流量业务对象类型	取消流量
能不能取消一百五十元的基础流量包 基础流量包 流量业务对象类型	取消流量
操作取消一百五十元基础流量包 基础流量包 流量业务对象类型	取消流量
可以帮我把一百五十元基础流量包取消吗 基础流量包 流量业务对象类型	取消流量
你知道怎么取消一百五十元基础流量包吗 基础流量包 流量业务对象类型	取消流量
如何取消一百五十元的基础流量包 基础流量包 流量业务对象类型	取消流量
帮我把一百五十元的基础流量包取消了吧 基础流量包 流量业务对象类型	取消流量
我需要取消一百五十元的基础流量包 基础流量包 流量业务对象类型	取消流量
你知道取消一百五十元基础流量包的方法吗 基础流量包 流量业务对象类型	取消流量
把一百五十元基础流量包取消谢谢了 基础流量包 流量业务对象类型	取消流量
一百五十元的基础流量包帮我取消了吧 基础流量包 流量业务对象类型	取消流量
取消基础流量包一百五十元的 基础流量包 流量业务对象类型	取消流量
一百五十元的基础流量包取消不要了 基础流量包 流量业务对象类型	取消流量
我能不能去下一百五十元的基础流量包 基础流量包 流量业务对象类型	取消流量
你能取消我的一百五十元基础流量包吗 基础流量包 流量业务对象类型	取消流量
怎样取消一百五十元的基础流量包 基础流量包 流量业务对象类型	取消流量
你赶紧帮我把基础流量包一百五十元的取消了吧 基础流量包 流量业务对象类型	取消流量
你这里能取消一百五十元的基础流量包吗 基础流量包 流量业务对象类型	取消流量
一百五十元的基础流量包取消一下 基础流量包 流量业务对象类型	取消流量
我办的那个一百五十的基础流量包取消不要了 基础流量包 流量业务对象类型	取消流量
基础流量包一百五十的取消了谢谢 基础流量包 流量业务对象类型	取消流量
一百五十的基础流量包不要了 基础流量包 流量业务对象类型	取消流量
可以取消一百五十元的基础流量包吗 基础流量包 流量业务对象类型	取消流量
我要取消二百元的基础流量包 基础流量包 流量业务对象类型	取消流量
帮我取消二百元钱的流量包基础的 基础流量包 流量业务对象类型	取消流量
我的二百元基础包想取消掉 基础流量包 流量业务对象类型	取消流量
能不能取消二百元的基础流量包 基础流量包 流量业务对象类型	取消流量
操作取消二百元基础流量包 基础流量包 流量业务对象类型	取消流量
可以帮我把二百元基础流量包取消吗 基础流量包 流量业务对象类型	取消流量
你知道怎么取消二百元基础流量包吗 基础流量包 流量业务对象类型	取消流量
如何取消二百元的基础流量包 基础流量包 流量业务对象类型	取消流量
帮我把二百元的基础流量包取消了吧 基础流量包 流量业务对象类型	取消流量
我需要取消二百元的基础流量包 基础流量包 流量业务对象类型	取消流量
你知道取消二百元基础流量包的方法吗 基础流量包 流量业务对象类型	取消流量
把二百元基础流量包取消谢谢了 基础流量包 流量业务对象类型	取消流量
二百元的基础流量包帮我取消了吧 基础流量包 流量业务对象类型	取消流量
取消基础流量包二百元的 基础流量包 流量业务对象类型	取消流量
二百元的基础流量包取消不要了 基础流量包 流量业务对象类型	取消流量
我能不能去下二百元的基础流量包 基础流量包 流量业务对象类型	取消流量
你能取消我的二百元基础流量包吗 基础流量包 流量业务对象类型	取消流量
怎样取消二百元的基础流量包 基础流量包 流量业务对象类型	取消流量
你赶紧帮我把基础流量包二百元的取消了吧 基础流量包 流量业务对象类型	取消流量
你这里能取消二百元的基础流量包吗 基础流量包 流量业务对象类型	取消流量
二百元的基础流量包取消一下 基础流量包 流量业务对象类型	取消流量
我办的那个二百的基础流量包取消不要了 基础流量包 流量业务对象类型	取消流量
基础流量包二百的取消了谢谢 基础流量包 流量业务对象类型	取消流量
二百的基础流量包不要了 基础流量包 流量业务对象类型	取消流量
可以取消二百元的基础流量包吗 基础流量包 流量业务对象类型	取消流量
我要取消三百元的基础流量包 基础流量包 流量业务对象类型	取消流量
帮我取消三百元钱的流量包基础的 基础流量包 流量业务对象类型	取消流量
我的三百元基础包想取消掉 基础流量包 流量业务对象类型	取消流量
能不能取消三百元的基础流量包 基础流量包 流量业务对象类型	取消流量
操作取消三百元基础流量包 基础流量包 流量业务对象类型	取消流量
可以帮我把三百元基础流量包取消吗 基础流量包 流量业务对象类型	取消流量
你知道怎么取消三百元基础流量包吗 基础流量包 流量业务对象类型	取消流量
如何取消三百元的基础流量包 基础流量包 流量业务对象类型	取消流量
帮我把三百元的基础流量包取消了吧 基础流量包 流量业务对象类型	取消流量
我需要取消三百元的基础流量包 基础流量包 流量业务对象类型	取消流量
你知道取消三百元基础流量包的方法吗 基础流量包 流量业务对象类型	取消流量
把三百元基础流量包取消谢谢了 基础流量包 流量业务对象类型	取消流量
三百元的基础流量包帮我取消了吧 基础流量包 流量业务对象类型	取消流量
取消基础流量包三百元的 基础流量包 流量业务对象类型	取消流量
三百元的基础流量包取消不要了 基础流量包 流量业务对象类型	取消流量
我能不能去下三百元的基础流量包 基础流量包 流量业务对象类型	取消流量
你能取消我的三百元基础流量包吗 基础流量包 流量业务对象类型	取消流量
怎样取消三百元的基础流量包 基础流量包 流量业务对象类型	取消流量
你赶紧帮我把基础流量包三百元的取消了吧 基础流量包 流量业务对象类型	取消流量
你这里能取消三百元的基础流量包吗 基础流量包 流量业务对象类型	取消流量
三百元的基础流量包取消一下 基础流量包 流量业务对象类型	取消流量
我办的那个三百的基础流量包取消不要了 基础流量包 流量业务对象类型	取消流量
基础流量包三百的取消了谢谢 基础流量包 流量业务对象类型	取消流量
三百的基础流量包不要了 基础流量包 流量业务对象类型	取消流量
可以取消三百元的基础流量包吗 基础流量包 流量业务对象类型	取消流量
给我把十元的加油包取消了 加油包 流量业务对象类型	取消流量
我想取消十元的加油包 加油包 流量业务对象类型	取消流量
十元的加油包没啥用取消了吧 加油包 流量业务对象类型	取消流量
我要取消十元的加油包好吗 加油包 流量业务对象类型	取消流量
可以取消十元的加油包吗 加油包 流量业务对象类型	取消流量
我十元的加油包不要了取消了吧 加油包 流量业务对象类型	取消流量
帮我把十元的加油包取消了 加油包 流量业务对象类型	取消流量
取消一下十元的加油包 加油包 流量业务对象类型	取消流量
帮我把十元的流量加油包取消掉 加油包 流量业务对象类型	取消流量
取消十元加油包好吗 加油包 流量业务对象类型	取消流量
请帮我取消十元的加油包吧 加油包 流量业务对象类型	取消流量
你这里能取消流量加油十元的吗 加油包 流量业务对象类型	取消流量
不小心开了一个十元的加油包帮我取消了吧 加油包 流量业务对象类型	取消流量
我想要取消加油包十元的 加油包 流量业务对象类型	取消流量
十元的加油包是个什么玩意赶紧给我取消的 加油包 流量业务对象类型	取消流量
帮我把十元的加油包流量取消谢谢啦 加油包 流量业务对象类型	取消流量
取消十元加油包爱你么么哒 加油包 流量业务对象类型	取消流量
给我取消了那个十元的加油包不想要了 加油包 流量业务对象类型	取消流量
我想取消掉十元的加油包好不好呀 加油包 流量业务对象类型	取消流量
那个十元的加油包我真的不想要了呀取消了吧 加油包 流量业务对象类型	取消流量
莫名其妙办了一个十元的加油包给我取消了我又没用 加油包 流量业务对象类型	取消流量
别啰嗦赶紧取消十元的那个破加油包 加油包 流量业务对象类型	取消流量
给我把二十元的加油包取消了 加油包 流量业务对象类型	取消流量
我想取消二十元的加油包 加油包 流量业务对象类型	取消流量
二十元的加油包没啥用取消了吧 加油包 流量业务对象类型	取消流量
我要取消二十元的加油包好吗 加油包 流量业务对象类型	取消流量
可以取消二十元的加油包吗 加油包 流量业务对象类型	取消流量
我二十元的加油包不要了取消了吧 加油包 流量业务对象类型	取消流量
帮我把二十元的加油包取消了 加油包 流量业务对象类型	取消流量
取消一下二十元的加油包 加油包 流量业务对象类型	取消流量
帮我把二十元的流量加油包取消掉 加油包 流量业务对象类型	取消流量
取消二十元加油包好吗 加油包 流量业务对象类型	取消流量
请帮我取消二十元的加油包吧 加油包 流量业务对象类型	取消流量
你这里能取消流量加油二十元的吗 加油包 流量业务对象类型	取消流量
不小心开了一个二十元的加油包帮我取消了吧 加油包 流量业务对象类型	取消流量
我想要取消加油包二十元的 加油包 流量业务对象类型	取消流量
二十元的加油包是个什么玩意赶紧给我取消的 加油包 流量业务对象类型	取消流量
帮我把二十元的加油包流量取消谢谢啦 加油包 流量业务对象类型	取消流量
取消二十元加油包爱你么么哒 加油包 流量业务对象类型	取消流量
给我取消了那个二十元的加油包不想要了 加油包 流量业务对象类型	取消流量
我想取消掉二十元的加油包好不好呀 加油包 流量业务对象类型	取消流量
那个二十元的加油包我真的不想要了呀取消了吧 加油包 流量业务对象类型	取消流量
莫名其妙办了一个二十元的加油包给我取消了我又没用 加油包 流量业务对象类型	取消流量
别啰嗦赶紧取消二十元的那个破加油包 加油包 流量业务对象类型	取消流量
给我把三十元的加油包取消了 加油包 流量业务对象类型	取消流量
我想取消三十元的加油包 加油包 流量业务对象类型	取消流量
三十元的加油包没啥用取消了吧 加油包 流量业务对象类型	取消流量
我要取消三十元的加油包好吗 加油包 流量业务对象类型	取消流量
可以取消三十元的加油包吗 加油包 流量业务对象类型	取消流量
我三十元的加油包不要了取消了吧 加油包 流量业务对象类型	取消流量
帮我把三十元的加油包取消了 加油包 流量业务对象类型	取消流量
取消一下三十元的加油包 加油包 流量业务对象类型	取消流量
帮我把三十元的流量加油包取消掉 加油包 流量业务对象类型	取消流量
取消三十元加油包好吗 加油包 流量业务对象类型	取消流量
请帮我取消三十元的加油包吧 加油包 流量业务对象类型	取消流量
你这里能取消流量加油三十元的吗 加油包 流量业务对象类型	取消流量
不小心开了一个三十元的加油包帮我取消了吧 加油包 流量业务对象类型	取消流量
我想要取消加油包三十元的 加油包 流量业务对象类型	取消流量
三十元的加油包是个什么玩意赶紧给我取消的 加油包 流量业务对象类型	取消流量
帮我把三十元的加油包流量取消谢谢啦 加油包 流量业务对象类型	取消流量
取消三十元加油包爱你么么哒 加油包 流量业务对象类型	取消流量
给我取消了那个三十元的加油包不想要了 加油包 流量业务对象类型	取消流量
我想取消掉三十元的加油包好不好呀 加油包 流量业务对象类型	取消流量
那个三十元的加油包我真的不想要了呀取消了吧 加油包 流量业务对象类型	取消流量
莫名其妙办了一个三十元的加油包给我取消了我又没用 加油包 流量业务对象类型	取消流量
别啰嗦赶紧取消三十元的那个破加油包 加油包 流量业务对象类型	取消流量
给我把五十元的加油包取消了 加油包 流量业务对象类型	取消流量
我想取消五十元的加油包 加油包 流量业务对象类型	取消流量
五十元的加油包没啥用取消了吧 加油包 流量业务对象类型	取消流量
我要取消五十元的加油包好吗 加油包 流量业务对象类型	取消流量
可以取消五十元的加油包吗 加油包 流量业务对象类型	取消流量
我五十元的加油包不要了取消了吧 加油包 流量业务对象类型	取消流量
帮我把五十元的加油包取消了 加油包 流量业务对象类型	取消流量
取消一下五十元的加油包 加油包 流量业务对象类型	取消流量
帮我把五十元的流量加油包取消掉 加油包 流量业务对象类型	取消流量
取消五十元加油包好吗 加油包 流量业务对象类型	取消流量
请帮我取消五十元的加油包吧 加油包 流量业务对象类型	取消流量
你这里能取消流量加油五十元的吗 加油包 流量业务对象类型	取消流量
不小心开了一个五十元的加油包帮我取消了吧 加油包 流量业务对象类型	取消流量
我想要取消加油包五十元的 加油包 流量业务对象类型	取消流量
五十元的加油包是个什么玩意赶紧给我取消的 加油包 流量业务对象类型	取消流量
帮我把五十元的加油包流量取消谢谢啦 加油包 流量业务对象类型	取消流量
取消五十元加油包爱你么么哒 加油包 流量业务对象类型	取消流量
给我取消了那个五十元的加油包不想要了 加油包 流量业务对象类型	取消流量
我想取消掉五十元的加油包好不好呀 加油包 流量业务对象类型	取消流量
那个五十元的加油包我真的不想要了呀取消了吧 加油包 流量业务对象类型	取消流量
莫名其妙办了一个五十元的加油包给我取消了我又没用 加油包 流量业务对象类型	取消流量
别啰嗦赶紧取消五十元的那个破加油包 加油包 流量业务对象类型	取消流量
十元夜间流量包取消了 夜间流量包 流量业务对象类型	取消流量
把我十元夜间流量包取消 夜间流量包 流量业务对象类型	取消流量
请取消我的十元夜间流量包 夜间流量包 流量业务对象类型	取消流量
请将我的十元夜间流量包取消 夜间流量包 流量业务对象类型	取消流量
我要取消十元夜间流量包 夜间流量包 流量业务对象类型	取消流量
我要将我的十元夜间流量包取消掉 夜间流量包 流量业务对象类型	取消流量
你能不能取消掉我的十元夜间流量包 夜间流量包 流量业务对象类型	取消流量
你可不可以取消我的十元夜间流量包 夜间流量包 流量业务对象类型	取消流量
请你帮我取消十元夜间流量包 夜间流量包 流量业务对象类型	取消流量
请帮我将十元夜间流量包取消 夜间流量包 流量业务对象类型	取消流量
我需要你帮我取消十元夜间流量包 夜间流量包 流量业务对象类型	取消流量
我需要将十元夜间流量包取消 夜间流量包 流量业务对象类型	取消流量
将我办理的十元夜间流量包取消 夜间流量包 流量业务对象类型	取消流量
请把我办理的十元夜间流量包取消 夜间流量包 流量业务对象类型	取消流量
把十元夜间流量包取消 夜间流量包 流量业务对象类型	取消流量
把我的十元夜间流量包给取消了 夜间流量包 流量业务对象类型	取消流量
取消六元小时流量包 小时流量包 流量业务对象类型	取消流量
六元小时流量包取消了 小时流量包 流量业务对象类型	取消流量
把我六元小时流量包取消 小时流量包 流量业务对象类型	取消流量
请取消我的六元小时流量包 小时流量包 流量业务对象类型	取消流量
请将我的六元小时流量包取消 小时流量包 流量业务对象类型	取消流量
我要取消六元小时流量包 小时流量包 流量业务对象类型	取消流量
我要将我的六元小时流量包取消掉 小时流量包 流量业务对象类型	取消流量
你能不能取消掉我的六元小时流量包 小时流量包 流量业务对象类型	取消流量
你可不可以取消我的六元小时流量包 小时流量包 流量业务对象类型	取消流量
请你帮我取消六元小时流量包 小时流量包 流量业务对象类型	取消流量
请帮我将六元小时流量包取消 小时流量包 流量业务对象类型	取消流量
我不要六元小时流量包了 小时流量包 流量业务对象类型	取消流量
我需要你帮我取消六元小时流量包 小时流量包 流量业务对象类型	取消流量
我需要将六元小时流量包取消 小时流量包 流量业务对象类型	取消流量
将我办理的六元小时流量包取消 小时流量包 流量业务对象类型	取消流量
请把我办理的六元小时流量包取消 小时流量包 流量业务对象类型	取消流量
我不需要六元小时流量包了 小时流量包 流量业务对象类型	取消流量
不需要六元小时流量包了 小时流量包 流量业务对象类型	取消流量
把六元小时流量包取消 小时流量包 流量业务对象类型	取消流量
把我的六元小时流量包给取消了 小时流量包 流量业务对象类型	取消流量
取消九元小时流量包 小时流量包 流量业务对象类型	取消流量
九元小时流量包取消了 小时流量包 流量业务对象类型	取消流量
把我九元小时流量包取消 小时流量包 流量业务对象类型	取消流量
请取消我的九元小时流量包 小时流量包 流量业务对象类型	取消流量
请将我的九元小时流量包取消 小时流量包 流量业务对象类型	取消流量
我要取消九元小时流量包 小时流量包 流量业务对象类型	取消流量
我要将我的九元小时流量包取消掉 小时流量包 流量业务对象类型	取消流量
你能不能取消掉我的九元小时流量包 小时流量包 流量业务对象类型	取消流量
你可不可以取消我的九元小时流量包 小时流量包 流量业务对象类型	取消流量
请你帮我取消九元小时流量包 小时流量包 流量业务对象类型	取消流量
请帮我将九元小时流量包取消 小时流量包 流量业务对象类型	取消流量
我不要九元小时流量包了 小时流量包 流量业务对象类型	取消流量
我需要你帮我取消九元小时流量包 小时流量包 流量业务对象类型	取消流量
我需要将九元小时流量包取消 小时流量包 流量业务对象类型	取消流量
将我办理的九元小时流量包取消 小时流量包 流量业务对象类型	取消流量
请把我办理的九元小时流量包取消 小时流量包 流量业务对象类型	取消流量
我不需要九元小时流量包了 小时流量包 流量业务对象类型	取消流量
不需要九元小时流量包了 小时流量包 流量业务对象类型	取消流量
把九元小时流量包取消 小时流量包 流量业务对象类型	取消流量
把我的九元小时流量包给取消了 小时流量包 流量业务对象类型	取消流量
取消一百元基础流量包 基础流量包 流量业务对象类型	取消流量
取消七十元基础流量包 基础流量包 流量业务对象类型	取消流量
为什么取消不了十元包一g全国夜间流量 夜间流量包 流量业务对象类型	取消流量
我的套餐为什么有一个十元的夜间包我之前包过一次不是时间到了自动取消么 夜间流量包 流量业务对象类型	取消流量
取消夜间十元包一g 夜间流量包 流量业务对象类型	取消流量
我要取消十元夜间套餐 夜间流量包 流量业务对象类型	取消流量
如何取消夜间十元一g流量 夜间流量包 流量业务对象类型	取消流量
把我的十包夜间一g流量取消 夜间流量包 流量业务对象类型	取消流量
请帮我取消十元包一g夜间流量包 夜间流量包 流量业务对象类型	取消流量
取消夜间流量十元包 夜间流量包 流量业务对象类型	取消流量
我想取消十元包一g夜间流量 夜间流量包 流量业务对象类型	取消流量
怎么取消夜间流量十包一g流量包 夜间流量包 流量业务对象类型	取消流量
请问我的十元一g夜间流量包可以取消么 夜间流量包 流量业务对象类型	取消流量
取消十元一g全国流量闲时流量叠加包 夜间流量包 流量业务对象类型	取消流量
如何取消十元包一g夜间流量 夜间流量包 流量业务对象类型	取消流量
您好十元包一g的流量夜间包可以取消吗 夜间流量包 流量业务对象类型	取消流量
取消十元包夜间一g流量包 夜间流量包 流量业务对象类型	取消流量
如何取消十元包夜间流量 夜间流量包 流量业务对象类型	取消流量
如何取消十元包一g夜间流量套 夜间流量包 流量业务对象类型	取消流量
取消夜间流量包十元包一g 夜间流量包 流量业务对象类型	取消流量
怎样取消十元包一g国内夜间流量包 夜间流量包 流量业务对象类型	取消流量
怎样取消十元一g闲时流量叠加包 夜间流量包 流量业务对象类型	取消流量
怎么取消十元一g闲时流量叠加包 夜间流量包 流量业务对象类型	取消流量
取消十国内闲时流量包 夜间流量包 流量业务对象类型	取消流量
取消十元闲时流量包 夜间流量包 流量业务对象类型	取消流量
取消十元闲时流量叠加包 夜间流量包 流量业务对象类型	取消流量
取消十元一g全国流量闲时 夜间流量包 流量业务对象类型	取消流量
如何取消十元一g闲时流量叠加流量包 夜间流量包 流量业务对象类型	取消流量
我的十元闲时流量包取消 夜间流量包 流量业务对象类型	取消流量
取消国内十元一g闲时流量叠加包 夜间流量包 流量业务对象类型	取消流量
取消十元全国闲时流量流量叠加包 夜间流量包 流量业务对象类型	取消流量
如何取消十元一g全国流量闲时流量叠加包 夜间流量包 流量业务对象类型	取消流量
十元一g全国流量闲时流量叠加包长期如何取消 夜间流量包 流量业务对象类型	取消流量
十元一g全国流量闲时流量叠加包怎么取消 夜间流量包 流量业务对象类型	取消流量
怎么取消十元包一g夜间闲时流量包 夜间流量包 流量业务对象类型	取消流量
取消十元一g全国流量闲时叠加流量包 夜间流量包 流量业务对象类型	取消流量
取消十元一g的闲时流量叠加包 夜间流量包 流量业务对象类型	取消流量
十元全国闲时流量包怎么取消 夜间流量包 流量业务对象类型	取消流量
十元闲时流量包取消 夜间流量包 流量业务对象类型	取消流量
怎样取消十元三g闲时流量叠加包 夜间流量包 流量业务对象类型	取消流量
十元一g国内流量闲时叠加包如何取消 夜间流量包 流量业务对象类型	取消流量
如何取消十闲时流量套餐 夜间流量包 流量业务对象类型	取消流量
十元一g国内闲时流量叠加包如何取消 夜间流量包 流量业务对象类型	取消流量
十块钱一g闲时流量能取消吧 夜间流量包 流量业务对象类型	取消流量
十元一g全国闲时流量叠加包怎么取消 夜间流量包 流量业务对象类型	取消流量
取消十元一g全国流量闲时叠加包 夜间流量包 流量业务对象类型	取消流量
怎么取消十元一g夜间流量包 夜间流量包 流量业务对象类型	取消流量
取消十元包一g夜间流量套餐 夜间流量包 流量业务对象类型	取消流量
取消十元一g国内夜间流量包怎么办 夜间流量包 流量业务对象类型	取消流量
帮我把夜间流量套餐十元包国内一g这个套餐取消 夜间流量包 流量业务对象类型	取消流量
怎么取消十元一夜间流量 夜间流量包 流量业务对象类型	取消流量
帮我取消十元一g的夜间流量 夜间流量包 流量业务对象类型	取消流量
取消十元一g的夜间流量包 夜间流量包 流量业务对象类型	取消流量
可以给我取消十元一g的夜间流量套餐吗 夜间流量包 流量业务对象类型	取消流量
取消夜间流量套餐国内十元一g 夜间流量包 流量业务对象类型	取消流量
如何取消十元一g国内夜间流量包 夜间流量包 流量业务对象类型	取消流量
取消夜间流量套餐十元一g 夜间流量包 流量业务对象类型	取消流量
怎么取消十元夜间国内流量包 夜间流量包 流量业务对象类型	取消流量
怎么取消夜间流量十 夜间流量包 流量业务对象类型	取消流量
我想取消十元夜间流量包 夜间流量包 流量业务对象类型	取消流量
取消十元夜间流量包业务 夜间流量包 流量业务对象类型	取消流量
怎么取消十元一g夜间流量 夜间流量包 流量业务对象类型	取消流量
我要取消三十元国内流量加油包 加油包 流量业务对象类型	取消流量
帮我退订十元一g流量日套餐 日流量包 流量业务对象类型	取消流量
帮忙取消4小时流量包 小时流量包 流量业务对象类型	取消流量
我要取消十元一百兆加油包 加油包 流量业务对象类型	取消流量
取消十元夜间流量包 夜间流量包 流量业务对象类型	取消流量
关掉十元夜间流量包 夜间流量包 流量业务对象类型	取消流量
我要取消五元五百兆流量包 周末流量包 流量业务对象类型	取消流量
取消我的十元夜间流量 夜间流量包 流量业务对象类型	取消流量
帮忙关了五元五百兆流量套餐 周末流量包 流量业务对象类型	取消流量
关掉十元夜间流量包 夜间流量包 流量业务对象类型	取消流量
有六元小时流量包吗 小时流量包 流量业务对象类型	开通流量
我想开通下九元的小时包可以吗 小时流量包 流量业务对象类型	开通流量
有五元短时流量包吗 周末流量包 流量业务对象类型	开通流量
十元一百兆国内加油包介绍 加油包 流量业务对象类型	开通流量
二十元一月流量加油包 加油包 流量业务对象类型	流量
十月一g夜间流量包怎么开 夜间流量包 流量业务对象类型	开通流量
我办个加油包只是在这一个月 加油包 流量业务对象类型	开通流量
你好我的流量包这个月不够用了我相加买加油包就用这一个月行吗 加油包 流量业务对象类型	开通流量
办个流量加油包这个月的 加油包 流量业务对象类型	开通流量
夜间流量包下个月可以取消吗 夜间流量包 流量业务对象类型	取消流量
我的夜间包之前打电话取消了为啥这个月还有阿 夜间流量包 流量业务对象类型	取消流量
夜间套餐取消还能用上月结转流量吗 夜间流量包 流量业务对象类型	取消流量
我定了两个的一月夜间流量包帮我取消一个 夜间流量包 流量业务对象类型	取消流量
夜间流量下个月开始取消 夜间流量包 流量业务对象类型	取消流量
夜间流量包下个月怎么取消 夜间流量包 流量业务对象类型	取消流量
我八月份定的夜间流量为啥取消不了 夜间流量包 流量业务对象类型	取消流量
下个月取消闲时流量 夜间流量包 流量业务对象类型	取消流量
十月一g全国流量闲时流量叠加包怎么取消 夜间流量包 流量业务对象类型	取消流量
这个月还能取消闲时套餐吗 夜间流量包 流量业务对象类型	取消流量
开通七十元三g流量一月咋开啊 70 金额	开通流量
七十元三g流量一月咋开啊 70 金额	开通流量
办理十元一百兆的流量当月的 10 金额	开通流量
十元的流量包赶紧取消下月不要了 10 金额	取消流量
二十元的流量包赶紧取消下月不要了 20 金额	取消流量
九元4小时省内快销包 小时流量包 流量业务对象类型	流量
六元4小时流量补给包 小时流量包 流量业务对象类型	流量
九元4小时快消包 小时流量包 流量业务对象类型	流量
六元4小时流量包 小时流量包 流量业务对象类型	流量
六元4小时省内快销包 小时流量包 流量业务对象类型	流量
六元4小时流量需要发送什么短信 小时流量包 流量业务对象类型	流量
国内六元4小时流量包 小时流量包 流量业务对象类型	流量
六元4小时包 小时流量包 流量业务对象类型	流量
六元4小时快消包 小时流量包 流量业务对象类型	流量
六元4小时短时包发送短信 小时流量包 流量业务对象类型	流量
六元4小时套餐 小时流量包 流量业务对象类型	流量
六元4小时流量包有效期 小时流量包 流量业务对象类型	流量
流量补给包六元4小时 小时流量包 流量业务对象类型	流量
六元五百兆4小时包 小时流量包 流量业务对象类型	流量
六元4小时急救包是不是通用流量 小时流量包 流量业务对象类型	流量
九元4小时流量需要发送什么短信 小时流量包 流量业务对象类型	流量
国内九元4小时流量包 小时流量包 流量业务对象类型	流量
九元4小时包 小时流量包 流量业务对象类型	流量
九元4小时流量补给包 小时流量包 流量业务对象类型	流量
九元4小时短时包发送短信 小时流量包 流量业务对象类型	流量
九元4小时套餐 小时流量包 流量业务对象类型	流量
九元4小时流量包有效期 小时流量包 流量业务对象类型	流量
流量补给包九元4小时 小时流量包 流量业务对象类型	流量
九元4小时流量包 小时流量包 流量业务对象类型	流量
办理的九元一g国内流量4小时从哪里扣费 小时流量包 流量业务对象类型	流量
九元一g4小时包 小时流量包 流量业务对象类型	流量
为別的手机号买五元五百兆二天包流量的怎样购买 5 金额	开通流量
五元五百兆两天包怎么办 5 金额	开通流量
我想开通省内二天五百兆五元的套餐回复短信什么数字 5 金额	开通流量
买五元4十八小时五百兆流量 5 金额	开通流量
五元五百兆流量包两天 5 金额	开通流量
给我开通一个五元五百兆的两天包 5 金额	开通流量
我办理二天包五元五百兆咋不行 5 金额	开通流量
我是订购五元五百兆4十八小时流量包 5 金额	开通流量
你好从哪里进入购买五元五百兆两天的流量包 5 金额	开通流量
刚才购买的五元五百兆二天包 5 金额	开通流量
我刚定了五元五百兆的流量两天包为什么用不了还是用的话费 5 金额	开通流量
开通十元加油包当月生效吗 加油包 流量业务对象类型	开通流量
开通六元4小时加油包 加油包 流量业务对象类型	开通流量
开通九元4小时加油包 加油包 流量业务对象类型	开通流量
取消下月十元夜间流量 夜间流量包 流量业务对象类型	取消流量
开通九块钱的4小时加油包 加油包 流量业务对象类型	开通流量
办个十元流量加油包这个月的 加油包 流量业务对象类型	开通流量
办个二十元流量加油包这个月的 加油包 流量业务对象类型	开通流量
办个三十元流量加油包这个月的 加油包 流量业务对象类型	开通流量
办个五十元流量加油包这个月的 加油包 流量业务对象类型	开通流量
只开这一个月的五十元加油包 加油包 流量业务对象类型	开通流量
三十元基础流量包取消下月不要了 基础流量包 流量业务对象类型	取消流量
五十元基础流量包取消下月不要了 基础流量包 流量业务对象类型	取消流量
七十元基础流量包取消下月不要了 基础流量包 流量业务对象类型	取消流量
一百元基础流量包取消下月不要了 基础流量包 流量业务对象类型	取消流量
一百五十元基础流量包取消下月不要了 基础流量包 流量业务对象类型	取消流量
二百元基础流量包取消下月不要了 基础流量包 流量业务对象类型	取消流量
三百元基础流量包取消下月不要了 基础流量包 流量业务对象类型	取消流量
还有六元包4小时流量吗 小时流量包 流量业务对象类型	开通流量
我想办理六元4小时的国内流量包 小时流量包 流量业务对象类型	开通流量
国内4小时流量包六元 小时流量包 流量业务对象类型	开通流量
我要办理六元4小时流量 小时流量包 流量业务对象类型	开通流量
我要开通六元4小时流量包 小时流量包 流量业务对象类型	开通流量
开通六元4小时流量包 小时流量包 流量业务对象类型	开通流量
我想办理六元4小时流量套餐 小时流量包 流量业务对象类型	开通流量
请问六块钱的4小时包怎么开通 小时流量包 流量业务对象类型	开通流量
申请六元4个小时流量包 小时流量包 流量业务对象类型	开通流量
我想开通六元4小时流量 小时流量包 流量业务对象类型	开通流量
六元4小时流量包开通 小时流量包 流量业务对象类型	开通流量
国内六元4小时流量包怎么办理 小时流量包 流量业务对象类型	开通流量
短信怎么办理六元4小时流量 小时流量包 流量业务对象类型	开通流量
六元4小时流量包怎么办理 小时流量包 流量业务对象类型	开通流量
有没有六元4小时的流量包 小时流量包 流量业务对象类型	开通流量
六元流量包4个小时 小时流量包 流量业务对象类型	开通流量
我想办理九元4小时的国内流量包 小时流量包 流量业务对象类型	开通流量
国内4小时流量包九元 小时流量包 流量业务对象类型	开通流量
我要办理九元4小时流量 小时流量包 流量业务对象类型	开通流量
办理九元4小时的流量 小时流量包 流量业务对象类型	开通流量
我要开通九元4小时流量包 小时流量包 流量业务对象类型	开通流量
开通九元4小时流量包 小时流量包 流量业务对象类型	开通流量
我想办理九元4小时流量套餐 小时流量包 流量业务对象类型	开通流量
请问九块钱的4小时包怎么开通 小时流量包 流量业务对象类型	开通流量
申请九元4个小时流量包 小时流量包 流量业务对象类型	开通流量
我想开通九元4小时流量 小时流量包 流量业务对象类型	开通流量
九元4小时流量包开通 小时流量包 流量业务对象类型	开通流量
国内九元4小时流量包怎么办理 小时流量包 流量业务对象类型	开通流量
九元4小时流量包怎么办理 小时流量包 流量业务对象类型	开通流量
开通五元两日流量包 日流量包 流量业务对象类型	开通流量
九元的就使用4个小时的怎么办理 小时流量包 流量业务对象类型	开通流量
六元能包国内4小时流量是多少 小时流量包 流量业务对象类型	开通流量
办理六元4小时的流量 小时流量包 流量业务对象类型	开通流量
开通六元4小时快销包 小时流量包 流量业务对象类型	开通流量
六块钱4小时流量包介绍 小时流量包 流量业务对象类型	开通流量
有没有短信开通六元4小时流量包开通方式 小时流量包 流量业务对象类型	开通流量
怎样用短信的方式开通六元4小时流量包啊 小时流量包 流量业务对象类型	开通流量
我想包六元4小时流量 小时流量包 流量业务对象类型	开通流量
六元4小时流量包发短信怎样开通呢 小时流量包 流量业务对象类型	开通流量
请问全国流量六块钱4小时的有没 小时流量包 流量业务对象类型	开通流量
包那个六元4个小时的流量包需要怎么办理 小时流量包 流量业务对象类型	开通流量
开通六块钱的4小时加油包 加油包 流量业务对象类型	开通流量
请问4小时包有没有六块钱的 小时流量包 流量业务对象类型	开通流量
办理的六元五百兆国内流量4小时从哪里扣费 小时流量包 流量业务对象类型	开通流量
九元能包国内4小时流量是多少 小时流量包 流量业务对象类型	开通流量
还有九元包4小时流量吗 小时流量包 流量业务对象类型	开通流量
开通九元4小时快销包 小时流量包 流量业务对象类型	开通流量
九块钱4小时流量包介绍 小时流量包 流量业务对象类型	开通流量
有没有短信开通九元4小时流量包开通方式 小时流量包 流量业务对象类型	开通流量
怎样用短信的方式开通九元4小时流量包啊 小时流量包 流量业务对象类型	开通流量
我想包九元4小时流量 小时流量包 流量业务对象类型	开通流量
九元4小时流量包发短信怎样开通呢 小时流量包 流量业务对象类型	开通流量
请问全国流量九块钱4小时的有没 小时流量包 流量业务对象类型	开通流量
短信怎么办理九元4小时流量 小时流量包 流量业务对象类型	开通流量
有没有九元4小时的流量包 小时流量包 流量业务对象类型	开通流量
包那个九元4个小时的流量包需要怎么办理 小时流量包 流量业务对象类型	开通流量
请问4小时包有没有九块钱的 小时流量包 流量业务对象类型	开通流量
短时4小时九元流量包怎么办理 小时流量包 流量业务对象类型	开通流量
退订六元4小时流量包 小时流量包 流量业务对象类型	取消流量
夜间加油包 夜间流量包 流量业务对象类型	流量
取消夜间加油包 夜间流量包 流量业务对象类型	取消流量
我将帮我开三十元的流量 30 金额	开通流量
我就要三十元的流量包 30 金额	开通流量
你帮我开通一元五百兆的流量 1 金额	开通流量
我要的是一元五百兆的 1 金额	开通流量
哦加油包 加油包 流量业务对象类型	流量
十元一百兆 10 金额	流量
加油包啊 加油包 流量业务对象类型	流量
量加油包 加油包 流量业务对象类型	流量
帮我查一下帮我查一下这个月我还有多少流量 +0 月份	查询流量
五十五十元加油包 加油包 流量业务对象类型	流量
二十元两百兆 20 金额	流量
呃流量办理加油包 加油包 流量业务对象类型	开通流量
办理三十元的 30 金额	开通
请问我这个月还有多少话费 +0 月份	查询余额
呃喂你好我刚刚充了一百块钱话费我想充到哪 100 金额	查询充值缴费记录
元包加油包 加油包 流量业务对象类型	流量
呃办理加油包 加油包 流量业务对象类型	开通流量
开通下个月还余多少 +1 月份	开通
粮校夜间流量 夜间流量包 流量业务对象类型	流量
退一下加油包 加油包 流量业务对象类型	取消流量
开加油包 加油包 流量业务对象类型	开通流量
办理十元加油包 加油包 流量业务对象类型	开通流量
查询服务密码 密码 附属标签	查询
我要加油包 加油包 流量业务对象类型	开通流量
办理夜间流量 夜间流量包 流量业务对象类型	开通流量
二十元包两百兆 20 金额	开通流量
唉请问请问什么敕令云杉的服务密码是多少 密码 附属标签	查询
网龄办理二十元加油包 加油包 流量业务对象类型	开通流量
修改密码拾音器 密码 附属标签	修改
办理加油包业务 加油包 流量业务对象类型	开通流量
夜间夜间流量 夜间流量包 流量业务对象类型	流量
我这个月消费多少 +0 月份	查询账单
五元加油包 加油包 流量业务对象类型	流量
办理加流包 加油包 流量业务对象类型	开通流量
三十元包五百兆 30 金额	开通流量
你这个没你好打的十元我昨昨订了我打的时间 10 金额	拒识1
你给我查查我这个号码怎么本月打不开 +0 月份	查询本机号码
我现在我的流量还有多少怎么就是加油包一下 加油包 流量业务对象类型	查询流量
我要查话费五块钱三十兆的石化厅达到二十块 5 金额	查询余额
二十元包三百兆 20 金额	开通流量
三百兆二十元三百兆 20 金额	流量
二十元套餐 20 金额	套餐
办理流量夜间包 夜间流量包 流量业务对象类型	开通流量
十元包一百兆 10 金额	开通流量
唉你好呃我的手机的密码是多少 密码 附属标签	查询
二十元包联五百兆 20 金额	开通流量
麻烦查一下本机的服务密码 密码 附属标签	查询
十元多兆一百五兆 10 金额	流量
请办理流量加油包就每天都要用的一个是每个 加油包 流量业务对象类型	开通流量
就办理五十五分海航的五十元的一个月一个g 50 金额	开通流量
退流量小时包 小时流量包 流量业务对象类型	取消流量
呃我想问一下我七月二十三号充了一个十块钱 7 月份	查询充值缴费记录
我要退掉下月的流量套餐 +1 月份	取消流量
办二十元加油包 加油包 流量业务对象类型	开通流量
七十本月中了还剩多少流量 +0 月份	查询流量
加油包我的加油包 加油包 流量业务对象类型	流量
五元包三十兆 5 金额	开通流量
三十元五百兆 30 金额	流量
办理加油包了 加油包 流量业务对象类型	开通流量
流量加油包业务 加油包 流量业务对象类型	流量
帮我十元我十 10 金额	具实帮助
二十元二十元二十元三百兆 20 金额	流量
我要办五十元呃一个际的 50 金额	办理
和查查我呃手机卡密码 密码 附属标签	查询
十元包五百兆 10 金额	开通流量
修改服务密码 密码 附属标签	修改手机
呃我想问一下话费可是流量的这个月的流流量 +0 月份	查询余额
服务加油包啊 加油包 流量业务对象类型	流量
帮我查查这个月还有多少话费和我还有多少流 +0 月份	查询余额
我需要当月流量 +0 月份	开通流量
我想充五十块钱话费有没有这个送 50 金额	办理手机充值
我想开一个十元的流量包 10 金额	开通流量
业加油包 加油包 流量业务对象类型	流量
二十元包二百兆 加油包 流量业务对象类型	开通流量
七月份话费七月份话费 7 月份	查询账单
开通六元快餐包 6 金额	开通
我说二十元三百兆流量是马上能生效吗 20 金额	流量
我这抱月的不是五十八块钱套餐吗 58 金额	查询本机业务
退订闲时流量 夜间流量包 流量业务对象类型	取消流量
办理加油包呢 加油包 流量业务对象类型	开通流量
我想办理呃十块钱的流量 10 金额	开通流量
请问我的这个月还有多少话费 +0 月份	查询余额
办理4g流量加油包 加油包 流量业务对象类型	开通流量
给我十块给我话费查一下 10 金额	查询余额
十元一百兆要 10 金额	开通流量
办理十元 10 金额	办理
我想办个加油包怎么办呢 加油包 流量业务对象类型	开通流量
十元两百兆二十元两百兆 10 金额	流量
查十元两百兆 10 金额	查询流量
查看流量加油包 加油包 流量业务对象类型	查询流量
给我查询我这个月的流量使用情况还剩余多少 +0 月份	查询流量
请问一下我的月我的夜间流量可不可以在外省 夜间流量包 流量业务对象类型	查询流量
帮我查下这个月的话费是多少 +0 月份	查询余额
我可以我可以查这个月的话费吗 +0 月份	查询余额
请查下本月的话费 +0 月份	查询余额
我想换一个密码了 密码 附属标签	修改
你加油包 加油包 流量业务对象类型	流量
十九你需要你复兴预订古井来自 19 数字	拒识1
闲时流量 夜间流量包 流量业务对象类型	流量
帮我办上之后加油包 加油包 流量业务对象类型	开通流量
我要定流量加油包 加油包 流量业务对象类型	开通流量
帮我查一下本月手机话费消费情况 +0 月份	查询账单
查八月份的账单 8 月份	查询账单
已订业务六月份到七月份 6 月份	查询本机业务
请你帮我查一下七月份的 7 月份	查询
是十元一百兆 10 金额	流量
十元一百兆的 10 金额	流量
挂上网加油包 加油包 流量业务对象类型	流量
嗯办理加油包 加油包 流量业务对象类型	开通流量
办理加油包二十元 加油包 流量业务对象类型	开通流量
确认确认二十元加油包 加油包 流量业务对象类型	流量
全国加油包 加油包 流量业务对象类型	流量
十元包一百查吗 10 金额	查询
买十块钱每刘营流量包 10 金额	开通流量
我要退订我包月的那个五十块钱一g的流量费 50 金额	取消流量
我要退订退订五十元的流量包 50 金额	取消流量
七月十五号账单 7 月份	查询账单
七月份全部账单 7 月份	查询账单
七月份手机gprs账单 7 月份	查询账单
七月帐单 7 月份	查询账单
查询六月 6 月份	查询
帮我那个二十兆二十块钱三百兆的流量包那个 20 金额	流量
办三十元的 30 金额	办理
夜间流量一般网上多少兆 夜间流量包 流量业务对象类型	流量
请给我办理十元加油包 加油包 流量业务对象类型	开通流量
办理加油包哦 加油包 流量业务对象类型	开通流量
查日间流量 日流量包 流量业务对象类型	查询流量
帮助我的日间流量有多少 日流量包 流量业务对象类型	查询流量
我办理五五十元的流量套餐 50 金额	开通流量
帮我办理十块钱夜间流量听不懂吗 夜间流量包 流量业务对象类型	开通流量
我刚刚包的六十块钱那个六个锯流量去哪里了 60 金额	集外说法集外业务咨询
二十元流量加油包 加油包 流量业务对象类型	流量
我这个月超了多少流量 +0 月份	查询流量
办理夜间加油包 夜间流量包 流量业务对象类型	开通流量
十块钱的流量加油包 10 金额	流量
我要办流量加油包 加油包 流量业务对象类型	开通流量
我要办理五十元的 50 金额	办理
办理十元的 10 金额	办理
办理夜间流量包好 夜间流量包 流量业务对象类型	开通流量
办理办理夜间流量包 夜间流量包 流量业务对象类型	开通流量
驻波办一个夜间流量包住 夜间流量包 流量业务对象类型	开通流量
廷杖陈大夜间流量包 夜间流量包 流量业务对象类型	流量
取消取消夜间流量包 夜间流量包 流量业务对象类型	取消流量
办理业办理夜间流量 夜间流量包 流量业务对象类型	开通流量
埠里有没有办理那个夜间流量包 夜间流量包 流量业务对象类型	开通流量
取消夜间流量包后 夜间流量包 流量业务对象类型	取消流量
加油包小语 加油包 流量业务对象类型	流量
加油包好吗 加油包 流量业务对象类型	流量
请问一请问一下我今天充了一百块钱有没有有 100 金额	查询充值缴费记录
我要办理加油包 加油包 流量业务对象类型	开通流量
我要办理十元一百兆的 10 金额	开通流量
十元三百兆 10 金额	流量
十元噢一百兆 10 金额	流量
我说我上个月嘛我给你查话我查话费他给我开 -1 月份	查询余额
我查一下夜间流量 夜间流量包 流量业务对象类型	查询流量
五元吗拜拜还有多一语音 5 金额	集外说法结束
六元五百兆六元五百兆 6 金额	流量
六月份的话费 6 月份	查询账单
包十元 10 金额	办理
客服密码多少 密码 附属标签	查询
呃五元加油包 加油包 流量业务对象类型	流量
呃五元三十兆 5 金额	流量
流量如何加油包什么monday办理加油包 加油包 流量业务对象类型	开通流量
充q币办理加油包 加油包 流量业务对象类型	开通流量
办理加油包么 加油包 流量业务对象类型	开通流量
办理三十元包五百兆一g了已经 30 金额	开通流量
宽带需要是不是确认三元包五百兆 3 金额	流量
吗能不能帮我打一个清单过来喂我这个月怎么 +0 月份	查询账单
嗯一下我这个月的消费 +0 月份	查询账单
嗯加油包吗 加油包 流量业务对象类型	流量
怎么如梦令乐桥流量小时包 小时流量包 流量业务对象类型	流量
一个十元流量包 10 金额	流量
办一个十元的 10 金额	办理
办理加油包茶缸一g效率呗 加油包 流量业务对象类型	开通流量
办加油包 加油包 流量业务对象类型	开通流量
流量加油包帮我办理 加油包 流量业务对象类型	开通流量
就是我这边办了一个六十元的呃六g的然后上 60 金额	流量
六十元六个g的 60 金额	流量
加油包怎么办挂的 加油包 流量业务对象类型	开通流量
那个三星三十八块钱的套餐如何退出啊 38 金额	办理套餐
办十元 10 金额	办理
呃流量加油包怎么加的 加油包 流量业务对象类型	开通流量
夜间加油包怎么办理 夜间流量包 流量业务对象类型	开通流量
能不能把我这个每个月返没三十块钱五十兆的 30 金额	流量
十二确认一笔要查 12 数字	查询
夜间流量导航伎俩到底 夜间流量包 流量业务对象类型	流量
办理二十元流量包 20 金额	开通流量
十元加油包确认 加油包 流量业务对象类型	流量
我想查一下我这个月还剩多少话费 +0 月份	查询余额
我想再办一下我想再办一下一个月中加油包 加油包 流量业务对象类型	开通流量
办理帮我办理加油包 加油包 流量业务对象类型	开通流量
查一下这个月的流量 +0 月份	查询流量
二十元是从哪里扣的 20 金额	查询账单
三加油包二十元 加油包 流量业务对象类型	流量
二十元包一百兆 20 金额	开通流量
话费充值卡充值话费 充值卡 附属标签	办理手机充值
帮我开通加油包 加油包 流量业务对象类型	开通流量
再办一个三个月 3 月份	办理
三个月五百兆 3 数字	流量
帮我办理那个加油包 加油包 流量业务对象类型	开通流量
办理办理加油包 加油包 流量业务对象类型	开通流量
办理夜间流量嘛 夜间流量包 流量业务对象类型	开通流量
嗯嗯二十元一百兆的流量啊 20 金额	流量
日流量套餐 日流量包 流量业务对象类型	流量
二五二特殊流量包住 252 数字	流量
宽带账号密码查询 密码 附属标签	查询
我想我想知道我的这个服务密码我不记得当初 密码 附属标签	查询
我要查本月话费 +0 月份	查询余额
五元三十兆 5 金额	流量
像我能不能呃那个流量包五元的 5 金额	流量
我要把加油包啊 加油包 流量业务对象类型	开通流量
我刚刚刚刚不是交过五十块钱那么还有欠费了 50 金额	集外说法集外业务咨询
我手机不刚刚我才充过五十块钱怎么还有欠费 50 金额	集外说法集外业务咨询
换办理十元的 10 金额	办理
十元包一百照 10 金额	流量
嗯流量加油包 加油包 流量业务对象类型	流量
办理加油包十块呢 加油包 流量业务对象类型	开通流量
办理二十元 20 金额	办理
手机密码手机号密码 密码 附属标签	手机
手机号码查询手机号码密码查询 密码 附属标签	查询本机号码
查询手机号密码 密码 附属标签	查询
嗯那个就是二十4块钱然后三十个g的那个呃 24 金额	流量
查一下六月底的 6 月份	查询
加油加油包二十块钱三十元查下账老是我说呢 30 金额	查询账单
流量办理办理加油包 加油包 流量业务对象类型	开通流量
我这个月的话费还剩多少啊 +0 月份	查询余额
你好我想问一下我那个是这月的话费已用了多 +0 月份	查询余额
你给我查查这月还有多少话费 +0 月份	查询余额
订十块钱的流量包 加油包 流量业务对象类型	开通流量
呃重置服务密码 密码 附属标签	重置手机
我这月的手机费还有多少钱 +0 月份	查询余额
多少取消目眩可在一起莱特选项不五十界别怎 50 数字	取消
发送网速办理加油包 加油包 流量业务对象类型	开通流量
加油包全部怎么搞转加油加油包 加油包 流量业务对象类型	流量
吗过退订流量加油包了流量卡流量加油包4g 加油包 流量业务对象类型	取消流量
话费的六十块 60 金额	查询余额
那信用卡这个月只 银行卡 附属标签	拒识1
呃其他没有了就是那个服服务密码 密码 附属标签	手机
我想办理那种五十八元一个月的 58 金额	办理
呃问一下我那个手机服务密码 密码 附属标签	手机
幽谷kb办那个闲时流量吗 夜间流量包 流量业务对象类型	开通流量
看看这个月的话费 +0 月份	查询余额
办十元包五百兆 10 金额	开通流量
能帮我办一个加柳林流量加油包 加油包 流量业务对象类型	开通流量
元加油包 加油包 流量业务对象类型	流量
我要那个十元流量包再加十块钱那个包那个十 10 金额	开通流量
在加油包了 加油包 流量业务对象类型	流量
我这月用了多少流量了 +0 月份	查询流量
有没有三十八元一个月的套餐啊 38 金额	办理套餐
我要办十元的流量包 10 金额	开通流量
客服密码是多少 密码 附属标签	查询
帮我办一个加油包呗 加油包 流量业务对象类型	开通流量
宽带移二十元 20 金额	宽带
帮我查一下我的手机密码是多少 密码 附属标签	查询
帮我办理加油包 加油包 流量业务对象类型	开通流量
办十元的 10 金额	办理
三十元包五百兆三十元包五百兆流量 30 金额	开通流量
噢追加十元二十元一个加油包 加油包 流量业务对象类型	开通流量
那个大宋过加油包流量请你疗养多少钱一分钟 加油包 流量业务对象类型	流量
办五块钱的 5 金额	办理
办五块钱上不了网我把办个网 5 金额	办理
流量包五元三十兆 5 金额	流量
二十元怎么样百兆 20 金额	流量
五元一百兆 5 金额	流量
我办那个夜间流量帮我关啊 夜间流量包 流量业务对象类型	取消流量
夜间流量取消了吗 夜间流量包 流量业务对象类型	查询流量
夜间流量取消掉 夜间流量包 流量业务对象类型	取消流量
查话费十月份的查话费 10 月份	查询账单
查本月话费 +0 月份	查询余额
查询夜间流量包 夜间流量包 流量业务对象类型	查询流量
本月流量 +0 月份	流量
嗯这卡开了手机卡的密码 密码 附属标签	手机
充流量加油包 加油包 流量业务对象类型	开通流量
忘记密码 密码 附属标签	重置
那为什么彩铃扣我三块钱的费用 3 金额	集外说法集外业务咨询
给我买二十元流量 20 金额	开通流量
加流量包呀十元 加油包 流量业务对象类型	开通流量
给我办一个十元流量包呀 10 金额	开通流量
我我这个月花了一百多块钱话费我叫你给我查 +0 月份	查询账单
请问剩余内疚夜里校阅二十元号码流量语音二 20 金额	查询流量
本机服务密码 密码 附属标签	手机
更正密码 密码 附属标签	修改
你好那个我这个月流量不能用了现在 +0 月份	集外说法集外业务咨询
十元一百兆全国流量包吧 10 金额	流量
查一下这两百多块钱话费啊 200 金额	查询余额
办理加油包服务办理加油包 加油包 流量业务对象类型	开通流量
十元流量包 10 金额	流量
办理三十的 30 金额	办理
取消夜间闲时流量包 夜间流量包 流量业务对象类型	取消流量
我的话费这个月还有多少啊 +0 月份	查询余额
我想请问一下我这个月的国内流量还剩余多少 +0 月份	查询流量
开通十元流量包呢 加油包 流量业务对象类型	开通流量
查询夜间流量 夜间流量包 流量业务对象类型	查询流量
不是办理加油包退订高中那个人工无聊的服务 加油包 流量业务对象类型	取消流量
我刚过啦 +0 月份	拒识1
十块钱帮我流量 10 金额	流量
加查流量二月话费流量 2 月份	查询账单
十元话费余额为你好其他信用嗯 20 金额	查询余额
办理五十元的加油包嗯 加油包 流量业务对象类型	开通流量
请问一下我这手机还有什么业务呃只交六十六 66 数字	查询本机业务
你你你知道我还有呃呃直接六十六元话费套呃 66 金额	查询余额
我这每个月请问一下我这个每个月套餐话费是 +0 月份	查询账单
我查查流量这月多少流量 +0 月份	查询流量
十元一百兆了 10 金额	流量
我那个我这个月上网流量了 +0 月份	流量
帮我这一个月流量还超多少兆 +0 月份	查询流量
噢还有冶山扣的二十的那个十块钱那个加油包 加油包 流量业务对象类型	流量
唉我查一下话费了我刚刚充了五十块话费怎么 50 金额	查询余额
退订加油包 加油包 流量业务对象类型	取消流量
我知道啊b六是不是在那个亮十月份流量还有 10 月份	流量
十元包一百兆呢 10 金额	流量
请问五元包月五元包三十兆 5 金额	开通流量
办理加油包啊 加油包 流量业务对象类型	开通流量
给我查这个月的话费 +0 月份	查询余额
改密码转人工 密码 附属标签	修改
加油包吧加油包 加油包 流量业务对象类型	流量
帮我开十元加油包 加油包 流量业务对象类型	开通流量
你好我嗯流量这个月是不是超了 +0 月份	查询流量
没有我问一下那个交一百块钱话费送流量是更 100 金额	集外说法集外业务咨询
它就是交一百块钱话费送流量 100 金额	集外说法集外业务咨询
那个夜间流量怎么办呢夜间流量怎么办呢 夜间流量包 流量业务对象类型	开通流量
办那个十元加油包 加油包 流量业务对象类型	开通流量
二宽带夜间你好本月的我把这 +0 月份	宽带
给我帮忙办十元一百兆的流量餐 加油包 流量业务对象类型	开通流量
哦办理十元加油包一百兆流量的 加油包 流量业务对象类型	开通流量
呃你好请问一下我这个月的话呃消费了多少然 +0 月份	查询账单
拐过我把加油包啊嗯 加油包 流量业务对象类型	流量
二十元包八百兆 20 金额	流量
办个加油包 加油包 流量业务对象类型	开通流量
办理十元啊 10 金额	办理
加油包不行的崽子 加油包 流量业务对象类型	流量
办理五块 5 金额	办理
假药加流量加油包 加油包 流量业务对象类型	开通流量
怎么加的流量帮我办理加油包一我想 加油包 流量业务对象类型	开通流量
音乐我帮我办理五元嗯五元 5 金额	办理
你好你给我查一下我这月流量多少啊 +0 月份	查询流量
这个月流量是多少兆 +0 月份	查询流量
我那个十块加十块钱的加油包吧 加油包 流量业务对象类型	流量
这个月这个话费怎么用这么多呢我没搞什么 +0 月份	查询账单
我查下我那个六位这个三个月话费哪个单子搞 3 数字	查询账单
十块的流量有多少 10 金额	开通流量
我加油包 加油包 流量业务对象类型	流量
昨天才我昨天余额五块多呢今天怎么欠了二十 5 金额	查询账单
我想问一下子昨天余额还剩五块多金额给我欠 5 金额	查询余额
我上次充两天充了两百块钱现在还有多少钱啊 200 金额	查询余额
我这个月话费用了多少 +0 月份	查询账单
我查这个月话费消费多少了 +0 月份	查询账单
我想办理一个五十块钱一个月的套餐 50 金额	办理套餐
我想请问我的那个那个这个月流量如果没有用 +0 月份	流量
办理办理五元流量加油包 加油包 流量业务对象类型	开通流量
我想把我这个月的那个除了那个流量包还有那 +0 月份	流量
帮我重置一下服务密码 密码 附属标签	重置手机
我想办理十元的那个流量 10 金额	开通流量
上网办理十元的流量包 10 金额	开通流量
二十元多少兆 20 金额	流量
办理五元先生流量加油包 加油包 流量业务对象类型	开通流量
我要办理流量就当天就可以用的是哪一种 日流量包 流量业务对象类型	开通流量
八三三呃三十元加油包 加油包 流量业务对象类型	流量
查询加油包 加油包 流量业务对象类型	查询流量
办理五元闲时流量加油包 夜间流量包 流量业务对象类型	开通流量
办理五元钱的流量加油包 加油包 流量业务对象类型	开通流量
十元喂 10 金额	集外说法友好问候
办理加油包套餐 加油包 流量业务对象类型	开通流量
五元五元三十兆 5 金额	流量
办理夜间闲时流量包 夜间流量包 流量业务对象类型	开通流量
重新办理夜间限时流量 夜间流量包 流量业务对象类型	开通流量
办理十元的流量 10 金额	开通流量
十元的流量加油包 加油包 流量业务对象类型	流量
我的手机号手机号码密码多少 密码 附属标签	查询
我办理这个加油包 加油包 流量业务对象类型	开通流量
可以已办夜间流量吗 夜间流量包 流量业务对象类型	开通流量
办五块加油包 加油包 流量业务对象类型	开通流量
请问一下我这个月我这个手机号怎么刚充了五 +0 月份	查询本机号码
加流量一三十块钱流量 30 金额	开通流量
帮我办理一下流量加油包 加油包 流量业务对象类型	开通流量
我这个月修改给我六我这个月的流量还有多少 +0 月份	查询流量
一下子工具书办理一百元三个g 100 金额	开通流量
为了话费还有多少我的话费还会就十块钱吗 10 金额	查询余额
手机加油包 加油包 流量业务对象类型	流量
能帮我查一下我这个月余那个流量余额还剩多 +0 月份	查询余额
嗯可以给我开一元五百兆的流量吗 1 金额	开通流量
开通流量加油包十元一百兆 加油包 流量业务对象类型	开通流量
查询一块钱 1 金额	查询
我想办五块钱的加油包 加油包 流量业务对象类型	开通流量
包十元十元 10 金额	开通流量
帮我查下七月份的 7 月份	查询
流量加油包流量加油包 加油包 流量业务对象类型	流量
俺加油包 加油包 流量业务对象类型	流量
十元一百兆改改掉了 10 金额	流量
我请你帮我查一下这个月的话费还剩多少分钟 +0 月份	查询余额
让你查一下我这个月的话费还有多少分钟没有 +0 月份	查询余额
就问办个月租六块的那个 6 金额	办理
增加个加油加油包 加油包 流量业务对象类型	开通流量
呃办理一个五十元的 加油包 流量业务对象类型	开通
我这个月的话费怎么使用吗 +0 月份	查询账单
我刚才办理加油包五十块钱加油包么怎么现在 加油包 流量业务对象类型	开通流量
我刚刚才办的还有五十元加呃办理五十元一个 50 金额	办理
我帮我办理花岗八里五十元登不起来手机高没 50 金额	办理
我刚才办理五十元我现在手机刚没流量刚才把 加油包 流量业务对象类型	开通流量
办理十元加油包十元 加油包 流量业务对象类型	开通流量
我就想问问看我这个月怎么会话费已用掉了七 +0 月份	集外说法集外业务咨询
唉问一下我那个彩铃你有没有哪它这个月给我 +0 月份	集外说法集外业务咨询
办理七十元的流量包 70 金额	开通流量
办理三元的 3 金额	办理
那个手机运营商密码是多少 密码 附属标签	查询
我办理加油包那几个字再见给我我问你查下我 加油包 流量业务对象类型	开通流量
人工办理加油包 加油包 流量业务对象类型	开通流量
我大圩加加油包流量包 加油包 流量业务对象类型	开通流量
喂一月我下月喂喂我的业务离地话费还有多少 +1 月份	查询余额
我买二十块钱流量 20 金额	开通流量
我姓一百二十块钱流量到月底清零 120 金额	流量
我刚刚交了一百块钱怎么没有收到 100 金额	集外说法集外业务咨询
我想办个十元的加油 10 金额	办理
呃你机器人打断十元的加油包 加油包 流量业务对象类型	流量
人工吧我就是说查给我网络发来十元人家二十 10 金额	具实转人工
办理加油包嗯 加油包 流量业务对象类型	开通流量
我的话费还有多少这个月啊 +0 月份	查询余额
我想办理一个十元的流量包 10 金额	开通流量
家庭宽带 群组宽带 宽带类型	宽带
加油包加油吧 加油包 流量业务对象类型	流量
五十元一个g业物 50 金额	流量
你流量加油包哪 加油包 流量业务对象类型	流量
办理流量加油包你续貂呗 加油包 流量业务对象类型	开通流量
我想开通一个十元的流量包 10 金额	开通流量
嗯就查刚才我老公给我交了五十块钱那个话费 50 金额	查询充值缴费记录
你故障微信嘛它帮我查吗办理加油包 加油包 流量业务对象类型	开通流量
加油包五元三十兆 加油包 流量业务对象类型	开通流量
五元包三十兆的 5 金额	开通流量
我的流量用了再查十块钱 10 金额	查询流量
我刚交的一百块钱话费怎么现在还没来呢没来 100 金额	集外说法集外业务咨询
我的手机我的话本月话费多少余额了基本话费 +0 月份	查询余额
流量包夜间流量 夜间流量包 流量业务对象类型	开通流量
嗯你好我问一下三十的了 30 数字	集外说法友好问候
你给我那十元流量包一百兆的 10 金额	开通流量
嗯加油包 加油包 流量业务对象类型	流量
你好我想查一下我这个月有没有开其它的业务 +0 月份	查询本机业务
帮我看一下这个月吧流量使用情况 +0 月份	查询流量
狮园加油包 加油包 流量业务对象类型	流量
取消每日里面流量包取消每个月十元的流量包 10 金额	取消流量
查查询宽带密码 密码 附属标签	查询
重听网点十月明天专用车不行怎么办呢 10 月份	具实重听
我包两元五百兆的 2 金额	开通流量
帮我开十元的流量包 10 金额	开通流量
加油包十块 加油包 流量业务对象类型	流量
呃我我这个月我流量用多少多查下流量 +0 月份	查询流量
伴有加油加油包 加油包 流量业务对象类型	流量
有没有加油有没有加油包 加油包 流量业务对象类型	开通流量
办理五元的 5 金额	办理
业务办理全球通五十八的套餐 58 金额	办理套餐
请帮我查一下这个我这个月的啊话费还有多少 +0 月份	查询余额
十元流量 10 金额	流量
弄一个流量加油包怎么加呢 加油包 流量业务对象类型	开通流量
就是说翁美玲二十流量明天什么时候 20 数字	流量
更改密码 密码 附属标签	修改
帮我开十块钱的流量包 10 金额	开通流量
呃我想帮我那个那个那个月租改成十八的可以 18 数字	办理套餐
我现在用的是那个三十八块钱包月的那个流量 38 金额	流量
你好我想办那个十元加油包 加油包 流量业务对象类型	开通流量
都不需要都不需要唉请问一下你们那个下个月 +1 月份	集外说法结束
开的书刊十元流量包 10 金额	开通流量
我要办理流量加油包呢 加油包 流量业务对象类型	开通流量
喂我查一下这个月的话费还有多少晓得唉 +0 月份	查询余额
现在查下这个月你给我查下这个月的一个月还 +0 月份	查询
给我搞加油包吧 加油包 流量业务对象类型	开通流量
十块钱买多少兆流量 10 金额	开通流量
包加油包办理加油包 加油包 流量业务对象类型	开通流量
十元一百兆加油包 加油包 流量业务对象类型	流量
呃我这个月都都二手使用量是操作是视作 +0 月份	拒识1
夜间流量查询 夜间流量包 流量业务对象类型	查询流量
滚你妈比较大十块钱费力了完啦你十九白矮星 10 金额	集外说法批评,抱怨,脏话
莲花九十块加集团 90 金额	拒识1
我这个月交了两百还有多少钱这里头 +0 月份	查询余额
你帮我这个月死数据连接能不能给我暂停 +0 月份	集外说法集外业务咨询
帮我上网流量三官加油包三个人了 加油包 流量业务对象类型	流量
三十元我增值了加油包和我不三十元加油包呢 加油包 流量业务对象类型	流量
办理这个我把一个十元一百兆 10 金额	开通流量
我要的家里那个嗯流量加油包 加油包 流量业务对象类型	开通流量
帮主夜间流量 夜间流量包 流量业务对象类型	流量
加油包再查 加油包 流量业务对象类型	查询流量
银行卡充值一g 银行卡 附属标签	办理手机充值
六十元业务能记得流量包 60 金额	流量
现在有什么加油包 加油包 流量业务对象类型	开通流量
办理三十元加油包 加油包 流量业务对象类型	开通流量
查流量五元 5 金额	查询流量
欠费了下落一年七月欠费零点零七元 7 月份	拒识1
三十元三个月办理帮我五百兆 30 金额	开通流量
你帮我套餐改成八块钱一个月的 8 金额	办理套餐
帮我查一下夜间流量 夜间流量包 流量业务对象类型	查询流量
给我包一起夜间流量 夜间流量包 流量业务对象类型	开通流量
请帮我查一下这个月的流量用了多少 +0 月份	查询流量
十元一百兆流量 10 金额	流量
一百兆流量十块钱 10 金额	流量
帮我开流量加油包流量加油包 加油包 流量业务对象类型	开通流量
流量流量加油包 加油包 流量业务对象类型	流量
三十元两包办理 30 金额	办理
我七月份打了多少电话费 7 月份	查询账单
九月取消 9 月份	取消
信用流量加油包 加油包 流量业务对象类型	流量
你帮我查一下我这个月还有多少话费可以用 +0 月份	查询余额
我想要我想要查我的那个都服务密码 密码 附属标签	查询
我要办理三十元的那种 30 金额	办理
可以帮我三十的 30 数字	具实帮助
使用加油包 加油包 流量业务对象类型	流量
帮我查一下这个月的话费用了多少 +0 月份	查询余额
你给我查一下这个月余额它这个流量就是那个 +0 月份	查询余额
查询查询开通了流量小时包 小时流量包 流量业务对象类型	查询流量
我要办理那个加油包 加油包 流量业务对象类型	开通流量
我说二十元的两百兆 20 金额	流量
帮我二十十块钱加油包我 加油包 流量业务对象类型	流量
包十元十元一百兆 10 金额	开通流量
查下这个月的流量还剩多少 +0 月份	查询流量
本月账单 +0 月份	查询账单
我我就想知道我这个月就是总的流量还剩下多 +0 月份	查询流量
4十元十元包一百兆 10 金额	开通流量
那办理加油包 加油包 流量业务对象类型	开通流量
办理一个五元的 5 金额	办理
取消取消我办十元我办二十元说普通话不标准 10 金额	取消
三十元套餐 30 金额	套餐
我想问一下我这个月你开通手机流量的怎么是 +0 月份	开通流量
服务密码怎么改呢 密码 附属标签	修改手机
我还剩了请问今天充五十块钱为什么没到账 50 金额	集外说法集外业务咨询
查加油包 加油包 流量业务对象类型	查询流量
人工二十 20 数字	具实转人工
流量五块嘛问一下不叠加查询话费 5 金额	查询余额
我要本机号码服务密码 密码 附属标签	查询
你好我当月的余额还有多少 +0 月份	查询余额
要十元的下个月就取消的十元的 +1 月份	取消
十元包一百兆是到月底结束是吧 10 金额	开通流量
我想办一个移动加油包 加油包 流量业务对象类型	开通流量
七月份的话费 7 月份	查询账单
我手机密码忘了可不可以帮我重新申请 密码 附属标签	重置手机
二百不用的重听找了谢谢你啊 200 金额	具实重听
嗯我要办加油包 加油包 流量业务对象类型	开通流量
就问办理流量挂流量补五月一个月包月五元 5 月份	开通流量
流量加油包办理 加油包 流量业务对象类型	开通流量
喂你好我想问一下嗯开一个加油包怎么开啊 加油包 流量业务对象类型	开通流量
帮我查一下这个月的话费 +0 月份	查询余额
欠费业务今个充值一百元怎么欠费了 100 金额	集外说法集外业务咨询
查话费毛今个充一百块怎么搞得一百块还欠费 100 金额	查询余额
给我办理十元一百兆 10 金额	开通流量
六元话费还有还有还有多少吗 6 金额	查询余额
办理加油包五块钱的加油包 加油包 流量业务对象类型	开通流量
呃加油包 加油包 流量业务对象类型	流量
查询我我的十七块了修改 17 金额	查询
三个g流量加油包 加油包 流量业务对象类型	流量
查询本月账单 +0 月份	查询账单
我没有加油包啊刚刚信息发了我我交了五百五 加油包 流量业务对象类型	流量
没有了就帮我查一下这个月的扣扣多少话费就 +0 月份	查询账单
买什么样的给我交话费五元 5 金额	办理手机充值
请你十元一百兆的 10 金额	流量
噢关了十元钱的那个流量包啊一百兆的 10 金额	取消流量
本月六合办理三十元的喂 +0 月份	办理
喂你好我上面的六元开通能说一下么把我这个 6 金额	集外说法友好问候
开流量加油包 加油包 流量业务对象类型	开通流量
本月我还剩还还剩它送多少话费我把怎么是分 +0 月份	查询余额
五元五元包三十兆五元三十兆 5 金额	流量
办理十元流量包手十元流量 10 金额	开通流量
十块钱流量包 10 金额	流量
我要办十块钱流量包 10 金额	开通流量
查询问我要七十块钱 70 金额	查询
哦我想问一下我这个月流量么用多少了 +0 月份	查询流量
咋知道不需要三十元包五百兆 30 金额	流量
加油加油包 加油包 流量业务对象类型	流量
刚才的十元退掉油油包三十元五百兆的 30 金额	流量
呃我想办一个那个加油包 加油包 流量业务对象类型	开通流量
办理一个十元的加油包 加油包 流量业务对象类型	开通流量
宣多少本月充值里面我不知道欠多少 +0 月份	办理手机充值
我要办当月流量套餐 +0 月份	开通流量
查县里十二月份流量在手电筒一 12 月份	流量
那个我想取消那个金沈三十八元套餐 38 金额	办理套餐
加三十元流量包 30 金额	开通流量
话费下个月 +1 月份	查询余额
夜间流量夜间流量怎么说 夜间流量包 流量业务对象类型	流量
我我办理一下那个加油包三十元的 加油包 流量业务对象类型	开通流量
你给我查一下嗯我我这个月还有多少流量 +0 月份	查询流量
查下查话费七十 70 数字	查询余额
油量加油包 加油包 流量业务对象类型	流量
办理加油加油包 加油包 流量业务对象类型	开通流量
查流量我那手机还有多少管乐一百七十啊 170 数字	查询流量
问一下这个月的流量有没有用超啊 +0 月份	查询流量
我这个月有什么增值业务吗 +0 月份	查询本机业务
呃上嗯办十块的五百兆的 10 金额	开通流量
帮助三十块 30 金额	具实帮助
噢我要我想加油加油包啊 加油包 流量业务对象类型	开通流量
加油包加油包给我 加油包 流量业务对象类型	流量
加加油包 加油包 流量业务对象类型	开通流量
查一下我的流量还有多少这个月 +0 月份	查询流量
呃确认充值卡充值 充值卡 附属标签	办理手机充值
交流量玖玖你好十元 10 金额	开通流量
十元十元包一百兆 10 金额	流量
加油包流量加油包我需要将剩余的套餐 加油包 流量业务对象类型	流量
帮我加油包十元流量加油包 加油包 流量业务对象类型	流量
我办理的十元加油包不是流量包 加油包 流量业务对象类型	开通流量
十元没流量 10 金额	流量
办三十元包 30 金额	办理
讲办办三十八块钱的月租啊包月的 38 金额	办理套餐
办理办理流量加油包 加油包 流量业务对象类型	开通流量
二十元流量吧 20 金额	流量
查询八月了 8 月份	查询
你帮我那个那个校讯通给他退掉退订掉从八月 8 月份	集外说法集外业务咨询
今个的嗯一百二十余额一没 120 数字	查询余额
嗯密码忘记了 密码 附属标签	重置
二十元三百兆 20 金额	流量
查询登录密码 密码 附属标签	查询
办理十元加油加油包 加油包 流量业务对象类型	开通流量
嗯我想你帮我查询一下我这个来电号码本月还 +0 月份	查询本机号码
喂喂喂喂十九一个月 19 数字	集外说法友好问候
你好我那给我全球通嗯五十八的套餐能取消吗 58 数字	办理套餐
呃加油包办理 加油包 流量业务对象类型	开通流量
我办十块钱加油包 加油包 流量业务对象类型	开通流量
我我要么不是流量加油包我要的就是那个套餐 加油包 流量业务对象类型	流量
我要的不是加油包是那个流就是套餐就是说有 加油包 流量业务对象类型	流量
给我充十块钱流量包吧 10 金额	开通流量
我订了交的五十块钱话费还没有欠费啊 50 金额	查询余额
我十元五百兆 10 金额	流量
我的服务密码多少 密码 附属标签	查询
我那个手机那个密码忘了 密码 附属标签	重置手机
办理六千夜间流量包 夜间流量包 流量业务对象类型	开通流量
呃交了我诗人刚才交纳五十元上个月还余多少 -1 月份	查询账单
你妈这个月的下辖喽 +0 月份	集外说法批评,抱怨,脏话
流量说流量加油包 加油包 流量业务对象类型	流量
五十元一g 50 金额	流量
办理加油包服务 加油包 流量业务对象类型	开通流量
我刚刚交了一百块钱话费帮我查一下有没到手 100 金额	查询充值缴费记录
帮我办办理一个流量加油包 加油包 流量业务对象类型	开通流量
办理二十元的 20 金额	办理
嗯我我办个山呃我要办九元享九元三个g流量 9 金额	开通流量
问这个月身份证我加油查一下哪 +0 月份	查询
十元流十元加油包 加油包 流量业务对象类型	流量
这里夜间流量还有不让打 夜间流量包 流量业务对象类型	流量
是三元加油包 加油包 流量业务对象类型	流量
我十元一g 10 金额	流量
我想改为幺三八也行是吧那行我五十八的不用 138 金额	办理套餐
五十八的五十八元的套餐是 58 金额	套餐
五十八元多少兆流量 58 金额	流量
十月流量流量 10 月份	流量
这方面的十块钱微信啊还有欠费音乐你你帮我 10 金额	具实帮助
十元十元的一百兆的 10 金额	流量
六位拜拜办理加油包 加油包 流量业务对象类型	开通流量
查夜间流量 夜间流量包 流量业务对象类型	查询流量
十元一百兆十元一百兆 10 金额	流量
嗯办理二十吧 20 金额	办理
帮我办理二十元的加油包 加油包 流量业务对象类型	开通流量
我想开一个三十元的呃加油包国内流量 加油包 流量业务对象类型	开通流量
流量加油包怎么办呢 加油包 流量业务对象类型	开通流量
帮我查一查帮我查一查本月话费 +0 月份	查询账单
十元一百五十兆 10 金额	流量
这个月流量好了吗 +0 月份	流量
我需要查询一下这个月还有多少流量 +0 月份	查询流量
我要十元的一百伎乐不一百一百m俩一百兆的 10 金额	流量
查询六月份话费单 6 月份	查询账单
查询七月份的 7 月份	查询
请帮我查询六月份的话费 6 月份	查询账单
嗯对啊我再查充值十块钱流量包吧 10 金额	开通流量
我要帮我办一个加油包 加油包 流量业务对象类型	开通流量
三百呃三十块钱五百兆吧 30 金额	流量
办理五十元一个际的 50 金额	开通流量
你们帮我办流量加油包吗 加油包 流量业务对象类型	开通流量
办理三十元五百兆 30 金额	开通流量
你好就是我在家里这个月租费十九的但是我来 +0 月份	集外说法友好问候
办理加油办理十元加油包 加油包 流量业务对象类型	开通流量
办二十元一百兆 20 金额	开通流量
办十元一百兆 10 金额	开通流量
加国际流量十月 10 月份	开通流量
退订夜间流量 夜间流量包 流量业务对象类型	取消流量
人工给我办理二十元加油包 加油包 流量业务对象类型	开通流量
喂我喂你好我那个那个流量费交了三十块钱我 30 金额	流量
可是我十月份一g 10 月份	流量
办个十元的 10 金额	办理
给我办十块钱的加油把猫一百兆的啊 加油包 流量业务对象类型	开通流量
郭寨加油包十块钱一百兆的 加油包 流量业务对象类型	流量
给我办理加油包十块一下一百兆的 加油包 流量业务对象类型	开通流量
流量加油包我有什么样的就是流量包了 加油包 流量业务对象类型	流量
五元五元包三十兆 5 金额	流量
查一下流量我还剩多少流量这个月 +0 月份	查询流量
五十元一个g 50 金额	流量
喂奶办理加油包 加油包 流量业务对象类型	开通流量
包十元的 10 金额	开通流量
一百兆十元一百兆 10 金额	流量
帮我办加油包 加油包 流量业务对象类型	开通流量
包十块钱吧 10 金额	开通
查话费啊这个这个月交了劳动量刘璋还不他家 +0 月份	查询余额
五元办理加油包五元三十兆加油五元三十兆加 加油包 流量业务对象类型	开通流量
我想要本机号码的服务密码 密码 附属标签	查询
花余额一百零八块 108 金额	查询余额
我交话费我要他人这个流量有三十八块钱一个 38 金额	办理手机充值
是有三十元的那个没啦那个流量 30 金额	流量
我的是三十元的流量包每月分钟我的意思啊一 30 金额	流量
查我这个月的流量还有多少 +0 月份	查询流量
手机密码修改 密码 附属标签	修改手机
就办理这样莲花呢三十元五百兆十元二百一百 30 金额	开通流量
就办理流量流量加油包 加油包 流量业务对象类型	开通流量
给我包个三十元包五百兆的 30 金额	开通流量
办理三十元五百兆怎么都不行啊 30 金额	开通流量
能给我办一个流量加油包三十元五百兆的 加油包 流量业务对象类型	开通流量
查询本月话费 +0 月份	查询余额
充是二十块钱加油包 加油包 流量业务对象类型	开通流量
人工三十元加油包吗呃 加油包 流量业务对象类型	流量
查询本月账单十八 +0 月份	查询账单
充五元流 5 金额	办理手机充值
办理信息五元的流流量包 5 金额	开通流量
呃帮帮我帮我嗯那个开一下全国流量加油包 加油包 流量业务对象类型	开通流量
呃你说吧这些是全国流量加油包吗 加油包 流量业务对象类型	流量
办理十元的三十元 10 金额	开通
来三十元那流量包三十元的流量包 30 金额	开通流量
办个十元的流量包 10 金额	开通流量
查夜间流量十元原谅 夜间流量包 流量业务对象类型	查询流量
十元加油包呢 加油包 流量业务对象类型	流量
转十元包一百兆 10 金额	开通流量
一百加油包 加油包 流量业务对象类型	流量
办理五元行不行 5 金额	办理
话费还余加油包可以叠 加油包 流量业务对象类型	查询余额
帮我办理十元流量包 10 金额	开通流量
帮我刚刚定的那个十元的流量套餐给我删掉 10 金额	取消流量
我我想办一下流量加油包 加油包 流量业务对象类型	开通流量
我办三十块钱五十兆立即生效当月都动取消这 30 金额	开通流量
三十元五十兆的立即生效月底自动取消明白 30 金额	取消流量
请包办夜间也是流量我来 夜间流量包 流量业务对象类型	开通流量
夜间流量啊十元的 夜间流量包 流量业务对象类型	流量
我想查一下我的手机服务密码是多少 密码 附属标签	查询
我这个月用的话费多少了 +0 月份	查询账单
查一下还击马鞍山市还十块的这个电话号码 10 金额	查询本机号码
办理十元流量包 10 金额	开通流量
我的增值业务有增值业务费六元是什么来的 6 金额	查询增值业务费
我想查增值业务费六元是怎么来的 6 金额	查询增值业务费
请你给我开五块钱流量 5 金额	开通流量
加油国史十块钱多少兆 10 金额	开通流量
流量加油包了 加油包 流量业务对象类型	流量
给我嘛我剩下嘛就是密友用了就我这个月余额 +0 月份	查询余额
噢原加油包 加油包 流量业务对象类型	流量
办理三元加油加油包 加油包 流量业务对象类型	开通流量
两元两元两元话费 2 金额	查询余额
五块钱多少流量 5 金额	开通流量
当月流量查询 +0 月份	查询流量
三元怎么查 3 金额	查询
加二十元加油包 加油包 流量业务对象类型	开通流量
我扣你大爷补办哦哦办理加油包 加油包 流量业务对象类型	开通流量
我要五元流量马上灵药五元五元流量包 5 金额	开通流量
给我办理加油包 加油包 流量业务对象类型	开通流量
办理五元加油包 加油包 流量业务对象类型	开通流量
请问一下我这个月的流量的多少 +0 月份	查询流量
喂我的手机我二百 200 数字	集外说法友好问候
您好我是有一个流量加油包 加油包 流量业务对象类型	流量
我需要一十月单集一百兆的确认 10 月份	开通流量
三十元查询五百兆 30 金额	查询流量
我加十块钱的流量套 10 金额	开通流量
帮我帮我充十块钱的流量 10 金额	开通流量
嗯办流办流量加油包 加油包 流量业务对象类型	开通流量
办流量加油包 加油包 流量业务对象类型	开通流量
帮我包三十元的五百兆 30 金额	开通流量
告诉你来我就是我我这五十八块的套餐怎么变 58 金额	套餐
帮助帮助我的五十八元的套餐 58 金额	套餐
另外我交的五十八块套餐里会用时为什么变成 58 金额	套餐
已经从八月一号开始改成十八的套餐了我自己 18 数字	套餐
我这个月有流量吗 +0 月份	查询流量
我这个月有流量吗我可以用流量吗 +0 月份	查询流量
加油包办理我可以余额用吗可以用流量吗 加油包 流量业务对象类型	开通流量
谢谢不要呃那个我这个话费怎么这个月用了这 +0 月份	查询余额
二十块钱没有流量包 20 金额	流量
吗本月查流量 +0 月份	查询流量
五点再点依立腾那个提交二百多 200 数字	拒识1
吧流量加油包 加油包 流量业务对象类型	流量
办十元的加油包 加油包 流量业务对象类型	开通流量
五元三十八五元三十兆 5 金额	流量
六元办理 6 金额	办理
呃帮助流量加油包 加油包 流量业务对象类型	流量
我要办理一百元 100 金额	办理
我这个月总共有多少流量 +0 月份	查询流量
我本月总共有多少数据流量 +0 月份	查询流量
我想彩铃我要退订夜间流量 夜间流量包 流量业务对象类型	取消流量
我要退订夜间流量 夜间流量包 流量业务对象类型	取消流量
帮我开一个五十块钱的加油包 加油包 流量业务对象类型	开通流量
那就给我办一个三十元的加油包吧国内流量 加油包 流量业务对象类型	开通流量
呃办夜间加油包怎么办理的 夜间流量包 流量业务对象类型	开通流量
夜间夜间流量包包十元再办理可不可以马上生 夜间流量包 流量业务对象类型	开通流量
在外我办一个三十元的流量包流量加油包国内 加油包 流量业务对象类型	开通流量
我停掉那个我订那个九元每 9 金额	取消
我想问一下这个我包的九元它是三g的那个腾 9 金额	开通流量
帮我查一下这个月的开机 +0 月份	查询
帮我十五元包 15 金额	具实帮助
上网手机的余额多少呀用到六十九块余额还有 69 金额	查询余额
查下这个月的流量吧 +0 月份	查询流量
办理三加油包 加油包 流量业务对象类型	开通流量
我想查一下还有多少流量这个月 +0 月份	查询流量
行套餐十八元 18 金额	套餐
办办理飞享套餐十八元一月 18 金额	办理套餐
我是查这个月的流量还有多少 +0 月份	查询流量
你帮我查一下我今天交了三十元 30 金额	查询充值缴费记录
我想办一个五元流量包 5 金额	开通流量
嗯办十元的 10 金额	办理
喂你好问一下我那个手机号码我刚充了五十块 50 金额	查询充值缴费记录
要办理二十元两百兆 20 金额	开通流量
能不能帮我那个三每个月最低消费三十八块钱 38 金额	集外说法集外业务咨询
交话费加流量加油包 加油包 流量业务对象类型	办理手机充值
吗查月费有服务密码 密码 附属标签	查询
加油包你 加油包 流量业务对象类型	流量
三十元剩余流量 30 金额	流量
办办理十元一百兆的 10 金额	开通流量
办理加油流量加油包 加油包 流量业务对象类型	开通流量
把我呃服务业务这个月欠费额度啊 +0 月份	查询余额
请问我这个月的话费余额还有多少 +0 月份	查询余额
给我办理加油包啊 加油包 流量业务对象类型	开通流量
怎么说啊我这个现在不上去啊我这个月的流量 +0 月份	集外说法集外业务咨询
我要我的本机号码的服务密码 密码 附属标签	查询
我这一个月总共有多少钱现在请二十多块钱了 20 金额	查询账单
给我把三十元的流量加油包 加油包 流量业务对象类型	流量
再报请你再帮我查一下这个月流量 +0 月份	查询流量
请你帮查一下这个月流量 +0 月份	查询流量
你给我查一下我我上个月用的话费多少钱 -1 月份	查询账单
你好我帮我查一下我这个月的话费还有多少 +0 月份	查询余额
办办理加油包 加油包 流量业务对象类型	开通流量
十元钱加油包 加油包 流量业务对象类型	流量
添加流量加油包 加油包 流量业务对象类型	开通流量
喂流量八月 8 月份	流量
办三元的 3 金额	办理
你给我查一下这个这个月的话费怎么这么多啊 +0 月份	集外说法集外业务咨询
五元充值照物 5 金额	办理手机充值
喂我手机缴费里套餐么六块可以外一月的 6 金额	办理手机充值
办理加油办理加油包 加油包 流量业务对象类型	开通流量
嗯办理流量加油包 加油包 流量业务对象类型	开通流量
你当月已使用话费有八块一毛钱 8 金额	查询余额
帮我查一下我这个月的流量使用情况 +0 月份	查询流量
请问我这个月的流量查流量太白帮我查一下 +0 月份	查询流量
加十元流量加油包 加油包 流量业务对象类型	开通流量
手机密码服务密码 密码 附属标签	手机
可人输手机密码来要听的交费 密码 附属标签	手机
办加油包怎么办理 加油包 流量业务对象类型	开通流量
哦办五十元呢 50 金额	办理
这个月我交了多少钱话费 +0 月份	查询充值缴费记录
查询七月账单 7 月份	查询账单
给我加十块钱流量 10 金额	开通流量
我讲说就确认一下子把十块钱的 10 金额	确认1
你好我刚才充了一百块钱除了年事充五十块钱 100 金额	集外说法友好问候
订购加油包 加油包 流量业务对象类型	开通流量
给我开给我开十元加油包 加油包 流量业务对象类型	开通流量
我网页这个月的话费余额还有多少 +0 月份	查询余额
我想问一下我这个是五十八的套餐畅想套餐能 58 数字	套餐
办理闲时流量 夜间流量包 流量业务对象类型	开通流量
这月还剩多少免费分钟 +0 月份	查询语音
办理流量流量加油包 加油包 流量业务对象类型	开通流量
我那个本月使用流量十五g然后包流量关了我 +0 月份	取消流量
请帮我查一下这个月的消费清单 +0 月份	查询账单
请把我这个月的消费清单话费我发个信息过来 +0 月份	查询账单
我想查一下我的流量这个月的流量超美钞然后 +0 月份	查询流量
查吗十元 10 金额	查询
流量取消小时包 小时流量包 流量业务对象类型	取消流量
我办理一个十元的流量包 10 金额	开通流量
日流量包 日流量包 流量业务对象类型	流量
充五十元加油包 加油包 流量业务对象类型	开通流量
我想办那个包月十八的套餐 18 数字	办理套餐
六元五百兆的套餐 6 金额	流量
能不能查一下当月的话费 +0 月份	查询账单
我要加油包一下子 加油包 流量业务对象类型	开通流量
两g五十就是说打好本机给我吗 50 数字	流量
好五元流量包 5 金额	流量
必须得我的仍能三十八给我插曲想取消这么多 38 数字	取消
二十元二十元两百兆的 20 金额	流量
办理加油包吗 加油包 流量业务对象类型	开通流量
二十中了十元两百兆的 20 金额	流量
办流量加油包二十两百兆的 加油包 流量业务对象类型	开通流量
二十元两百兆的 20 金额	流量
你好我想办加油包 加油包 流量业务对象类型	开通流量
拜拜多少了办个三十元五百兆 30 金额	开通流量
办个十元办个十元一百兆的 10 金额	开通流量
十元一百兆虚拟机 10 金额	流量
查流量没有了十块了 10 金额	查询流量
我想退订那个加油包吗 加油包 流量业务对象类型	取消流量
我是想七天芜湖办的加油包 加油包 流量业务对象类型	开通流量
确认十元加油包确认 加油包 流量业务对象类型	流量
我办理咨询块钱的加油包 加油包 流量业务对象类型	开通流量
我想知道本机的客服密码 密码 附属标签	查询
网速十元一百兆吧 10 金额	流量
办理二十元两百兆的 20 金额	开通流量
更改密码通过 密码 附属标签	修改
呃办个五元要办五元的加油包 加油包 流量业务对象类型	开通流量
办理加油包三十元加油包 加油包 流量业务对象类型	开通流量
办那个十块钱的加油包 加油包 流量业务对象类型	开通流量
这月啊小语么 +0 月份	集外说法机器人
那我想喂我想每六g每个加油包好吧 加油包 流量业务对象类型	流量
呃帮我办个加油包 加油包 流量业务对象类型	开通流量
你在办个十元的 10 金额	办理
外敌办理加油包 加油包 流量业务对象类型	开通流量
我办十元流量包 10 金额	开通流量
包办十元流量包 10 金额	开通流量
我想问一下我这个月流量还有多少 +0 月份	查询流量
十元包十元流量包 10 金额	流量
帮我开通二十元流量包 20 金额	开通流量
包括十元加油包 加油包 流量业务对象类型	流量
二十元我们三g路过 20 金额	流量
您好喂我加十块可嘉十块娶你流量的 10 金额	开通流量
办理加油包十块 加油包 流量业务对象类型	开通流量
你帮我开个十元的加油包 加油包 流量业务对象类型	开通流量
帮我办个十元的 10 金额	办理
帮我办个五元五元的加油包 加油包 流量业务对象类型	开通流量
加油包吗 加油包 流量业务对象类型	流量
请问话费余额还有多少今天交了一百块钱怎么 100 金额	查询余额
喂你好请把我那个这个月的这个呃这个流量再 +0 月份	流量
查我这个月开 +0 月份	查询
唉我的话这个月的话费还有多少还有这个这个 +0 月份	查询余额
这个月还有多少分钟 +0 月份	查询语音
开通加加油包 加油包 流量业务对象类型	开通流量
三十元的加油包 加油包 流量业务对象类型	流量
办流量流量加油包 加油包 流量业务对象类型	开通流量
开通十块钱加油包 加油包 流量业务对象类型	开通流量
办理加油包办理加油包 加油包 流量业务对象类型	开通流量
五元三十兆我们五元三十兆 5 金额	流量
五块钱我查尔斯有货 5 金额	查询
查询一下本月套餐使用情况 +0 月份	查询套餐余量
帮我查查这个月流量还有多少 +0 月份	查询流量
银行卡充值话费 银行卡 附属标签	办理手机充值
银行卡银联卡充值话费 银行卡 附属标签	办理手机充值
用银联卡充值话费怎么充 银行卡 附属标签	办理手机充值
夜间流量包是什么意思啊 夜间流量包 流量业务对象类型	流量
我想加油包 加油包 流量业务对象类型	流量
给我加十元油包 加油包 流量业务对象类型	开通流量
二十元一点五个g都办了 20 金额	开通流量
手手机服务密码 密码 附属标签	手机
帮我查一下六月的充值记录 6 月份	查询充值缴费记录
叠加夜间流量包 夜间流量包 流量业务对象类型	开通流量
十元开通十元 10 金额	开通
我想别的五十八元包办我取消掉吧一百零八的 58 金额	取消
查询一下我的这个月的那个套餐是是什么 +0 月份	查询套餐余量
嗯服务密码 密码 附属标签	手机
我包了十九块钱的流量是是是不是国内的三百 19 金额	流量
我微信金冲了十九块钱的然后三百兆是不是国 19 金额	流量
现在我开通有什么业务今天开通了一个呃二十 20 数字	查询本机业务
办个五元的 5 金额	办理
加油的那个那个加油包是什么 加油包 流量业务对象类型	流量
安徽移动上面那个是我用鼠十五元一g的那个 15 金额	流量
我他二十我这个流量就给我开什么开通什么东 20 数字	开通流量
办理五元上网套餐 5 金额	开通流量
五十元话费 50 金额	查询余额
短信五十元 50 金额	短信
呃请问一下就是我想五块钱包邮流量 5 金额	开通流量
加油包加油包 加油包 流量业务对象类型	流量
现在就是现在五块钱不呃就是开通了现在就可 5 金额	开通
我那个今天刚开的那个流量加油包我怎么现在 加油包 流量业务对象类型	流量
十元十元流量包 10 金额	流量
本机的密码是多少 密码 附属标签	手机
查询下个月的套餐 +1 月份	查询本机业务
十元一百兆叠加包 10 金额	流量
二十元的两百兆 20 金额	流量
查询一下六月份的缴费记录 6 月份	查询充值缴费记录
六月份帐单查询 6 月份	查询账单
取消一个月十块钱 10 金额	取消
三十元的三十元五百兆 30 金额	流量
我上个月用了多少钱 -1 月份	查询账单
我的手机号码服务密码是多少 密码 附属标签	查询
请把我这个月的话费就是查一下 +0 月份	查询余额
我这个卡有我这个卡有没有夜间流量 夜间流量包 流量业务对象类型	查询流量
我要查一下流量它这个月还有多少流量 +0 月份	查询流量
十元包十元包一百兆 10 金额	开通流量
十块十块五百兆 10 金额	流量
我想咨询一下那个g的流量几的加油包累计埠 加油包 流量业务对象类型	流量
我事我咨询一下我如果要办五十五十元大化一 50 金额	办理
我就想咨询一下如果已加油包流量用不掉下个 加油包 流量业务对象类型	流量
我想让你给我查一下这个月的话费用了多少 +0 月份	查询账单
五月份的还账单五月非常呢 5 月份	查询账单
五月份账单 5 月份	查询账单
账单4月份 4 月份	查询账单
我的那个什么十块钱的那个什么帮我弄掉 10 金额	取消
夜间流量包夜间流量包 夜间流量包 流量业务对象类型	开通流量
加油包加油包快餐包办理 加油包 流量业务对象类型	开通流量
开通五元夜间流量加油包 夜间流量包 流量业务对象类型	开通流量
请帮我查这个月的流量还剩多少 +0 月份	查询流量
我帮朋友买加油包行不行 加油包 流量业务对象类型	开通流量
十元一百兆的加油包 加油包 流量业务对象类型	流量
十元加油包办理 加油包 流量业务对象类型	开通流量
晚上流量 夜间流量包 流量业务对象类型	流量
查当月的话费 +0 月份	查询余额
喂你好我这个月的话费管嗯这个流量是怎么回 +0 月份	查询余额
你好那个你你帮我开那个包二十元的吗 20 金额	开通
就是家不是那个无线十元三十兆吗我家二十元 10 金额	流量
我把二十元零二十元二百兆连 20 金额	流量
不是你就帮我开通二十元二百兆的流量 20 金额	开通流量
唉安心包安心包做爱十块钱二百兆的 10 金额	流量
那个十元的十元一百兆 10 金额	流量
三十加三十兆 10 金额	开通流量
我我的那个服务密码是多少这个手机号 密码 附属标签	手机
办理十元的啊 10 金额	办理
我想加一个二十元钱的流量包加油包 加油包 流量业务对象类型	开通流量
退出二十的 20 数字	具实退出
加流量办理流量加油包 加油包 流量业务对象类型	开通流量
服务密码六吗 密码 附属标签	手机
不是加油包你听我说我在二十二十就是前几天 加油包 流量业务对象类型	流量
我办理的是我办理的是六十元五十二g 60 金额	流量
二十元包五百兆 20 金额	开通流量
办个十元 10 金额	办理
十元一百十元一百兆 10 金额	流量
给我买十块钱一个月那个一百兆你们跟临时用 10 金额	开通流量
我想办那个流量加油包 加油包 流量业务对象类型	开通流量
我需要查询流量这个月 +0 月份	查询流量
夜间流量包不 夜间流量包 流量业务对象类型	流量
我需要十块钱三十兆的十块钱以及桂寨流量 10 金额	开通流量
帮我办理十块钱流量 10 金额	开通流量
帮我办理十元一百兆人流量包 10 金额	开通流量
十元包信息机开的取消 10 金额	取消
五元流量包 5 金额	流量
我要办理十元加油包 加油包 流量业务对象类型	开通流量
就是我每次安徽移动侵到这月流量再和芜湖这 +0 月份	流量
呃六十六元这我这怎么消费的宽带流量 66 金额	集外说法集外业务咨询
帮我查一下我这个月的流量情况 +0 月份	查询流量
那个六元五百兆退掉可以吗 6 金额	取消流量
你可是我手机就交话费来充了一百充了 100 数字	办理手机充值
二十十元加油包 加油包 流量业务对象类型	流量
服务密码重设置 密码 附属标签	重置手机
我想问一下我那个夜间流量还剩多少 夜间流量包 流量业务对象类型	查询流量
三元十元一百兆 10 金额	流量
我看十元流量套餐 10 金额	流量
我要查询我的这个密码 密码 附属标签	查询
将我的是三十八元套餐改成 38 金额	办理套餐
流量关于流量为什么我订了十元的套餐的流量 10 金额	开通流量
办理二十的吗 20 金额	办理
三十兆三十兆是多少三十元十块钱是多少兆 30 金额	查询流量
返回帮我办一下那个三十元的 30 金额	办理
夜间流量是几点钟开始 夜间流量包 流量业务对象类型	流量
我查下流那个加油包吧 加油包 流量业务对象类型	查询流量
给我开一下那个开一下加油包吗 加油包 流量业务对象类型	开通流量
给我这个月的话费还剩多少 +0 月份	查询余额
开加油包可以可以吗 加油包 流量业务对象类型	开通流量
其它的不要了办理好十元的就可以啊十元加油 10 金额	办理
十元开的业务 10 金额	查询本机业务
我我查一下我的话费我才刚交了不久一百块钱 100 金额	查询余额
最低消费五十八给我查询这个套餐 58 金额	套餐
给我查最低消费五十八六十八送多少分钟多少 58 金额	查询
我就查这个月的 +0 月份	查询
我这月话费痘疤的多少 +0 月份	查询余额
呃我想问一下它这个加油包余额办理的话在全 加油包 流量业务对象类型	开通流量
五元多少兆流量 5 金额	流量
五元五元多少兆流量 5 金额	流量
我想请问一下我的流量没有了我想办一下十五 15 数字	开通流量
家庭计划两元套餐 2 金额	套餐
办理加油包十元加油包 加油包 流量业务对象类型	开通流量
把我这个手机号码给我下个月情况 +1 月份	查询本机号码
把我加三十元的加油包 加油包 流量业务对象类型	开通流量
办理办理十元加油包 加油包 流量业务对象类型	开通流量
我要包五元五百兆的流量 5 金额	开通流量
有没有五元五百兆 5 金额	开通流量
五百个流量 500 数字	流量
我就我就问一下那个呃今天刚交的一百块钱是 100 金额	查询充值缴费记录
我想办理这个加油包那个增加流量 加油包 流量业务对象类型	开通流量
你给我办理那个十十元的 10 金额	办理
办理五元三十兆 5 金额	开通流量
我要把我的套餐改掉改掉从下个月开始最低月 +1 月份	办理套餐
帮我开十块钱的加油包 加油包 流量业务对象类型	开通流量
我刚才买老是十块钱的流量为什么到现在还不 10 金额	开通流量
嗯给我办理那个三十五有三十元那个流量加油 30 金额	开通流量
短信服务密码 密码 附属标签	手机
我那个慢乐在你这办了两元的那个套餐为什么 2 金额	办理套餐
呃那个密码发给我啊就可以了宽带密码 密码 附属标签	查询
上网服务密码 密码 附属标签	手机
那六元五百兆 6 金额	流量
帮我查一下五十八的嗯八十八的就是流量套餐 58 数字	查询流量
加五元流量包 5 金额	开通流量
加二十元流量包呢 20 金额	开通流量
退流量我订了一个嗯二十元二十4个三个g的 20 金额	取消流量
查一查我本月花费还有多少 +0 月份	查询余额
呃请你查查我本月话费还有多少 +0 月份	查询余额
帮我加个流量加油包 加油包 流量业务对象类型	开通流量
十块钱五十一百兆 10 金额	流量
银行卡充值可以吗 银行卡 附属标签	办理手机充值
你哪里充值可以吗银行卡充值 银行卡 附属标签	办理手机充值
两加油包啊 加油包 流量业务对象类型	流量
十元开通 10 金额	开通
我这个月可有办成呀其他业务吗 +0 月份	办理
呃你好请问一下我那个密这个卡的密码是多少 密码 附属标签	查询
对那个服务密码我没服务密码忘记了 密码 附属标签	重置手机
你好你就是我办一下手机流量手机流量加油包 加油包 流量业务对象类型	开通流量
加十元流量包 10 金额	开通流量
你好我想办理加油包啊 加油包 流量业务对象类型	开通流量
哦暂时三十元那个加油包 加油包 流量业务对象类型	流量
呃割断取消哦我说我定的连十元那个流量 10 金额	取消流量
我要办理十元包一百兆 10 金额	开通流量
流量你看我这个月流量剩多少查流量查流量 +0 月份	查询流量
三十元五百兆流量包 30 金额	流量
三十元办五十包五百兆 30 金额	开通流量
我三十元加油包 加油包 流量业务对象类型	流量
那我想问一下办那个办理加油包得花十块短信 加油包 流量业务对象类型	开通流量
二十元的是多少钱一加油不多少兆的 20 金额	流量
嗯嘛你现在给我办二十元的 20 金额	办理
请帮助我要十元的流量加 10 金额	开通流量
五元请办五元 5 金额	办理
你给我讲是包月我办理肯定是二十不是怎么呢 20 数字	办理
人家w有没保有把那个人行办理流量加油包 加油包 流量业务对象类型	开通流量
本机密码 密码 附属标签	手机
就是查一下那个六十4了吗那个话费嘛一个月 64 数字	查询余额
好嗯十元流量 10 金额	流量
说我不是我就我就充的话费就我教化重新五十 50 数字	办理手机充值
二十元的加油包 加油包 流量业务对象类型	流量
我现在这个套餐是九十八的嗯说嗯能不能降低 98 数字	办理套餐
我办理加油包 加油包 流量业务对象类型	开通流量
俺加油包庇办过了么 加油包 流量业务对象类型	查询流量
我前面我前面已经开通了十元加油包你看要还 加油包 流量业务对象类型	开通流量
再办了十元你在办个十元的 10 金额	办理
我想查下就是月租改一改为八元的套餐把这个 8 金额	办理套餐
不是我想要的是这个月套餐呃就是下个月就改 +1 月份	办理套餐
办办十元的 10 金额	办理
上网流量改为二十元一个月 20 金额	开通流量
三十元五百兆的 30 金额	流量
需求我这个月的流量再查多少 +0 月份	查询流量
我办理一下加油包都有多少的 加油包 流量业务对象类型	开通流量
帮我办理业务嗯外省的加油包 加油包 流量业务对象类型	开通流量
加量包加油包 加油包 流量业务对象类型	流量
十元包办十元 10 金额	办理
查一下五月份的流量 5 月份	查询流量
五月份的那个流量用了多少 5 月份	查询流量
需要上个月的话费账单 -1 月份	查询账单
二十包五百兆 20 数字	开通流量
拿开再查帮我十块钱这样一个优惠洋溢一种上 10 金额	查询
主课夜间流量包是全国通用的吗 夜间流量包 流量业务对象类型	流量
喂你好我这个月流量是怎么搞的我说清楚 +0 月份	集外说法集外业务咨询
十元没有了 10 金额	集外说法结束
为啥停机我二十多块钱那种五十接呢 20 金额	集外说法集外业务咨询
你这个月不就送流量啊 +0 月份	集外说法集外业务咨询
嗯呢充了我充了十块但是又发信息给我说我帐 10 金额	集外说法集外业务咨询
呼叫这个月操作查账 +0 月份	查询账单
二十元一百兆 20 金额	流量
我想问一下我的手机服务密码是多少 密码 附属标签	查询
我这个月流量还有多少 +0 月份	查询流量
那我那不是五元是花到哪里去的呀那我那个怎 5 金额	集外说法集外业务咨询
帮我查一下六月份的账单 6 月份	查询账单
办理五天流量包一百零八包五天 5 数字	开通流量
五元确认五元三十兆的 5 金额	流量
呃我的我的手机那个呃嗯是那个卡关机密码忘 密码 附属标签	手机
你好我这个月流流量是怎么搞的 +0 月份	查询流量
开通业务查询我想问一下我那个五十元我开通 50 金额	查询本机业务
我开通那个五十元那个注册的那个流量流量包 50 金额	开通流量
机使用能办什么手机三十元话费是怎么搞的 30 金额	集外说法集外业务咨询
查十元的加油加油包 加油包 流量业务对象类型	查询流量
我要把夜间流量包 夜间流量包 流量业务对象类型	流量
夜间夜间流量是怎么算的 夜间流量包 流量业务对象类型	流量
夜间流量是每天晚上一个g吗 夜间流量包 流量业务对象类型	流量
呃我想开五块钱的流量现在立即生效可以吗 5 金额	开通流量
办那个加油包 加油包 流量业务对象类型	开通流量
那十块的加油包是一百兆吗 加油包 流量业务对象类型	流量
那个这个月底要用磨白客服核实说呀 +0 月份	具实转人工
怎么十元我想订了重听小语是什么 10 金额	具实重听
五月份的话费 5 月份	查询账单
查五月份的账单 5 月份	查询账单
不要这个不要这是十元一切的夜间加油包一g 夜间流量包 流量业务对象类型	流量
那个你看你帮我这个月已使用多少流量了良品 +0 月份	查询流量
麻烦给我查一下呃这个月的流呃流量还剩多少 +0 月份	查询流量
帮我申请一个夜间流量包 夜间流量包 流量业务对象类型	开通流量
给我查五个月的 5 数字	查询
再查几天五元 5 金额	查询
请问一下你帮我办一下晚间的淫靡本机流量好 夜间流量包 流量业务对象类型	开通流量
我想给我查一下我这个月怎么说我消费了七十 +0 月份	查询
我这个手机号服务密码是多少 密码 附属标签	查询
为什么为什么为什么我的流量这个月还有上网 +0 月份	集外说法集外业务咨询
办个五元的加油包 加油包 流量业务对象类型	开通流量
呃夜间流量吧 夜间流量包 流量业务对象类型	流量
给我再办一个十元的加油包 加油包 流量业务对象类型	开通流量
十元三十兆还十元一百兆 10 金额	流量
办二十元 20 金额	办理
二十二十元两百兆 20 金额	流量
我那个手机服务密码 密码 附属标签	手机
十元十元一百兆的 10 金额	流量
你好我想办理一下十元的流是今天确定一直 10 金额	开通流量
就是买个十元的流量 10 金额	开通流量
就是白天的流量包流量 日流量包 流量业务对象类型	开通流量
流流流量夜间包 夜间流量包 流量业务对象类型	流量
我把二十块钱的流量你给我办吗 20 金额	开通流量
不用二十块钱二十六块钱流量包 20 金额	开通流量
带小语你好办理加油包 加油包 流量业务对象类型	开通流量
小月小语十二月你好妒火分路采集器怎么才能 12 月份	集外说法机器人
三十八元飞享套餐 38 金额	套餐
你好我想办理一个流量加油包三十块钱五百兆 加油包 流量业务对象类型	开通流量
那个我想办一下那个流量加油包 加油包 流量业务对象类型	开通流量
办理一百元4十g 100 金额	开通流量
我想查当月话费 +0 月份	查询余额
五十元包一业务十元包一个g 50 金额	开通流量
查询三十元 30 金额	查询
流量加油包小节 加油包 流量业务对象类型	流量
呃办那个七十元两个g的 70 金额	开通流量
呃本月办一个加油包 加油包 流量业务对象类型	开通流量
呃二十元五百g 20 金额	流量
我想查询直上个月的华中别的号码里面转过来 -1 月份	查询本机号码
我本月还有多少流量 +0 月份	查询流量
帮我办理三十块钱流量加油包 加油包 流量业务对象类型	开通流量
我想办个办个这个开流量二十块钱的加油包 加油包 流量业务对象类型	开通流量
我那个刚增加的流量夜间流量包他什么时候生 夜间流量包 流量业务对象类型	流量
我说的是夜间流量包不是说代李办的哪一种流 夜间流量包 流量业务对象类型	流量
我这个夜间办理流量是今天生效然后完了是这 夜间流量包 流量业务对象类型	流量
三十元包五十八服务百兆 30 金额	开通流量
我我我问你一下请问一下呃我这个业务七月怎 7 月份	查询本机业务
喂你加油包 加油包 流量业务对象类型	流量
二十元二百兆 20 金额	流量
套餐改为二十元一个月的 20 金额	办理套餐
我十六十元包的六g为什么还没有到 10 金额	流量
六十元包三g柳集一百八十三消费掉你们的这 60 金额	开通流量
一百元包三g 100 金额	开通流量
办理加油包号码 加油包 流量业务对象类型	开通流量
一百一十八元的套餐挑给你激活报过来 118 金额	套餐
我退了不看我现在这个月的三百五十分钟剩余 +0 月份	取消
十五元一个际的流量包是呃 15 金额	流量
我想取消每个月每个月十元一百兆了流量包 10 金额	取消流量
呃那你就给我办个加油包吧 加油包 流量业务对象类型	开通流量
我请问一下我这个上个月怎么话费用掉这么多 -1 月份	查询余额
三十元人工服务 30 金额	具实转人工
我我这个月用了多少话费了 +0 月份	查询余额
呃流量加油包给这个流量包啥意思呢套餐是啥 加油包 流量业务对象类型	流量
两g可来说费我警校用了好比三十块钱我知道 30 金额	流量
三十元五百兆绿柱石我电费打长途vas你也 30 金额	流量
我需要三十元五百兆 30 金额	开通流量
我这我我还是不明白我三十元五百兆是大连市 30 金额	流量
里加油包 加油包 流量业务对象类型	流量
套餐加油包 加油包 流量业务对象类型	流量
喂流量加油包 加油包 流量业务对象类型	流量
办十十元 10 金额	办理
帮我充十块钱的加油包 加油包 流量业务对象类型	开通流量
我以前的密码是多少 密码 附属标签	查询
帮我办十元的加油包 加油包 流量业务对象类型	开通流量
帮我先办个五元的加油包试试 加油包 流量业务对象类型	开通流量
不是我这个这卡呃我是交费的不是充值卡我下 充值卡 附属标签	办理手机充值
我想请问一下流量加油包怎么办 加油包 流量业务对象类型	开通流量
帮我把我的套餐从下个月开始取消 +1 月份	办理套餐
宽带更换密码 密码 附属标签	修改宽带
长势晚三十元包我把下午八兆 30 金额	流量
我要办理十元的 10 金额	办理
我办加油包 加油包 流量业务对象类型	开通流量
是什么密码 密码 附属标签	查询
你好我想问一下我的这个主套餐十三十八元是 38 金额	查询本机业务
想改成要五元套餐不要 5 金额	办理套餐
我就是想把那个三十八元的套餐给退订退掉改 38 金额	办理套餐
嗯五元三十兆了下个月开始用可以吗 5 金额	流量
我要开这个流量加油包 加油包 流量业务对象类型	开通流量
查六月份账单 6 月份	查询账单
五元三十兆嗯 5 金额	流量
加油包喂 加油包 流量业务对象类型	流量
给我开通十元加油包 加油包 流量业务对象类型	开通流量
办理加油包二十 加油包 流量业务对象类型	开通流量
五元三g五元三三十兆的 5 金额	流量
我要去掉那个每个月二十元包三百兆流量的套 20 金额	取消流量
取消那个二十元包三十兆流量的套餐 20 金额	取消流量
我要取消二十元包三百兆流量那个套餐 20 金额	取消流量
加油包加流量 加油包 流量业务对象类型	开通流量
我想请问我想办那个加油包了 加油包 流量业务对象类型	开通流量
麻烦办个那个十元里吗 10 金额	办理
十元包确认 10 金额	确认1
我这个手机上有一个固定的三块钱的一个套餐 3 金额	套餐
查看本月话费账单 +0 月份	查询账单
噢小语给我加油包加油包 加油包 流量业务对象类型	开通流量
帮我十块钱的 10 金额	具实帮助
请帮我办理一下本月的剩余流量 +0 月份	查询流量
帮我办理了下个月三十三十元了三十元包月 +1 月份	办理
二月份包十兆 2 月份	开通流量
办理夜间包 夜间流量包 流量业务对象类型	开通流量
九元一g 9 金额	流量
噢办多少钱的五元三十兆十元一百兆我我我透 5 金额	开通流量
帮我查一下这个月的话费十元套餐情况 10 金额	查询余额
呃就是查一下前一个月就降了好谢谢啊 -1 月份	查询
你好我要办理加油包 加油包 流量业务对象类型	开通流量
呃五元包三十兆 5 金额	开通流量
五元包三十兆加油包 加油包 流量业务对象类型	开通流量
十十元十元加油包 加油包 流量业务对象类型	流量
喂请问你我这个这个月话费是多少登录查一下 +0 月份	查询余额
加油包搞个十块的 加油包 流量业务对象类型	流量
办理办加油包 加油包 流量业务对象类型	开通流量
十元十元加油包 加油包 流量业务对象类型	流量
办一下流量加油包 加油包 流量业务对象类型	开通流量
加油包嗯 加油包 流量业务对象类型	流量
十元多少兆 10 金额	流量
好放开那个十元的流量加油包 加油包 流量业务对象类型	流量
十月份我的套餐外的入列十块钱流量还得几天 10 月份	流量
包十元帮我一百兆 10 金额	开通流量
嗯我加油包 加油包 流量业务对象类型	流量
我协办十块钱套餐呃那个加油包 加油包 流量业务对象类型	开通流量
我要查询这个月的话费 +0 月份	查询余额
办二十元流量加油包 加油包 流量业务对象类型	开通流量
充值这个月 +0 月份	办理手机充值
我要去掉那个二十元二十元包三百三百兆流量 20 金额	取消流量
我要去掉那个二十元包方没流量的套餐 20 金额	办理套餐
加油包办理加油包 加油包 流量业务对象类型	开通流量
机任我用话费一百二十五元 125 金额	查询余额
二十元流量包啊 20 金额	流量
你给我办一个十元的呃流量加油包 加油包 流量业务对象类型	开通流量
我今天中午充的十五块钱三百兆流量怎么还没 15 金额	流量
我五元是多少兆 5 金额	流量
我五元加油包 加油包 流量业务对象类型	流量
开通我想请问一下我那个查流量才交了一百块 100 金额	查询流量
流量加油包流量加油包怎么办理呢 加油包 流量业务对象类型	开通流量
五元的流量帮我办一个 5 金额	开通流量
有没有一元三百兆的流量 1 金额	流量
五月流量 5 月份	流量
五月流量的 5 月份	流量
帮我帮帮我帮我申请一个夜间流量 夜间流量包 流量业务对象类型	开通流量
帮我充十元的加油包 加油包 流量业务对象类型	开通流量
我交五元的话费可以吗 5 金额	办理手机充值
交五元话费可以冲五元的这个月的流量吗 5 金额	办理手机充值
我没有办过五元的你给我办办一下五元的流量 5 金额	开通流量
五元加油包五元加油包 加油包 流量业务对象类型	流量
余额二十 20 数字	查询余额
我这个月打了多少电话费 +0 月份	查询账单
给我加十块钱加油包 加油包 流量业务对象类型	开通流量
我这个流这个月流量鹅舍装好啊 +0 月份	流量
